date,enrollment,DayOfWeek,Month,Year,IsWeekend,number,cumulative
2007-01-01,16,Monday,January,2007,False,16,16
2007-01-02,2,Tuesday,January,2007,False,2,18
2007-01-03,2,Wednesday,January,2007,False,2,20
2007-01-04,4,Thursday,January,2007,False,4,24
2007-01-05,3,Friday,January,2007,False,3,27
2007-01-06,0,Saturday,January,2007,True,0,27
2007-01-07,0,Sunday,January,2007,True,0,27
2007-01-08,1,Monday,January,2007,False,1,28
2007-01-09,4,Tuesday,January,2007,False,4,32
2007-01-10,8,Wednesday,January,2007,False,8,40
2007-01-11,1,Thursday,January,2007,False,1,41
2007-01-12,6,Friday,January,2007,False,6,47
2007-01-13,0,Saturday,January,2007,True,0,47
2007-01-14,2,Sunday,January,2007,True,2,49
2007-01-15,4,Monday,January,2007,False,4,53
2007-01-16,3,Tuesday,January,2007,False,3,56
2007-01-17,3,Wednesday,January,2007,False,3,59
2007-01-18,1,Thursday,January,2007,False,1,60
2007-01-19,5,Friday,January,2007,False,5,65
2007-01-20,1,Saturday,January,2007,True,1,66
2007-01-21,1,Sunday,January,2007,True,1,67
2007-01-22,1,Monday,January,2007,False,1,68
2007-01-23,3,Tuesday,January,2007,False,3,71
2007-01-24,4,Wednesday,January,2007,False,4,75
2007-01-25,2,Thursday,January,2007,False,2,77
2007-01-26,3,Friday,January,2007,False,3,80
2007-01-27,0,Saturday,January,2007,True,0,80
2007-01-28,0,Sunday,January,2007,True,0,80
2007-01-29,6,Monday,January,2007,False,6,86
2007-01-30,1,Tuesday,January,2007,False,1,87
2007-01-31,6,Wednesday,January,2007,False,6,93
2007-02-01,8,Thursday,February,2007,False,8,101
2007-02-02,5,Friday,February,2007,False,5,106
2007-02-03,2,Saturday,February,2007,True,2,108
2007-02-04,0,Sunday,February,2007,True,0,108
2007-02-05,4,Monday,February,2007,False,4,112
2007-02-06,3,Tuesday,February,2007,False,3,115
2007-02-07,8,Wednesday,February,2007,False,8,123
2007-02-08,8,Thursday,February,2007,False,8,131
2007-02-09,3,Friday,February,2007,False,3,134
2007-02-10,0,Saturday,February,2007,True,0,134
2007-02-11,0,Sunday,February,2007,True,0,134
2007-02-12,3,Monday,February,2007,False,3,137
2007-02-13,1,Tuesday,February,2007,False,1,138
2007-02-14,7,Wednesday,February,2007,False,7,145
2007-02-15,0,Thursday,February,2007,False,0,145
2007-02-16,4,Friday,February,2007,False,4,149
2007-02-17,0,Saturday,February,2007,True,0,149
2007-02-18,0,Sunday,February,2007,True,0,149
2007-02-19,3,Monday,February,2007,False,3,152
2007-02-20,6,Tuesday,February,2007,False,6,158
2007-02-21,0,Wednesday,February,2007,False,0,158
2007-02-22,4,Thursday,February,2007,False,4,162
2007-02-23,4,Friday,February,2007,False,4,166
2007-02-24,0,Saturday,February,2007,True,0,166
2007-02-25,0,Sunday,February,2007,True,0,166
2007-02-26,3,Monday,February,2007,False,3,169
2007-02-27,2,Tuesday,February,2007,False,2,171
2007-02-28,7,Wednesday,February,2007,False,7,178
2007-03-01,8,Thursday,March,2007,False,8,186
2007-03-02,2,Friday,March,2007,False,2,188
2007-03-03,0,Saturday,March,2007,True,0,188
2007-03-04,0,Sunday,March,2007,True,0,188
2007-03-05,7,Monday,March,2007,False,7,195
2007-03-06,1,Tuesday,March,2007,False,1,196
2007-03-07,3,Wednesday,March,2007,False,3,199
2007-03-08,5,Thursday,March,2007,False,5,204
2007-03-09,2,Friday,March,2007,False,2,206
2007-03-10,1,Saturday,March,2007,True,1,207
2007-03-11,0,Sunday,March,2007,True,0,207
2007-03-12,3,Monday,March,2007,False,3,210
2007-03-13,3,Tuesday,March,2007,False,3,213
2007-03-14,4,Wednesday,March,2007,False,4,217
2007-03-15,7,Thursday,March,2007,False,7,224
2007-03-16,2,Friday,March,2007,False,2,226
2007-03-17,0,Saturday,March,2007,True,0,226
2007-03-18,0,Sunday,March,2007,True,0,226
2007-03-19,4,Monday,March,2007,False,4,230
2007-03-20,2,Tuesday,March,2007,False,2,232
2007-03-21,2,Wednesday,March,2007,False,2,234
2007-03-22,3,Thursday,March,2007,False,3,237
2007-03-23,4,Friday,March,2007,False,4,241
2007-03-24,0,Saturday,March,2007,True,0,241
2007-03-25,0,Sunday,March,2007,True,0,241
2007-03-26,4,Monday,March,2007,False,4,245
2007-03-27,0,Tuesday,March,2007,False,0,245
2007-03-28,6,Wednesday,March,2007,False,6,251
2007-03-29,2,Thursday,March,2007,False,2,253
2007-03-30,2,Friday,March,2007,False,2,255
2007-03-31,,Saturday,March,2007,True,0,255
2007-04-01,,Sunday,April,2007,True,0,255
2007-04-02,3,Monday,April,2007,False,3,258
2007-04-03,1,Tuesday,April,2007,False,1,259
2007-04-04,9,Wednesday,April,2007,False,9,268
2007-04-05,6,Thursday,April,2007,False,6,274
2007-04-06,2,Friday,April,2007,False,2,276
2007-04-07,0,Saturday,April,2007,True,0,276
2007-04-08,0,Sunday,April,2007,True,0,276
2007-04-09,0,Monday,April,2007,False,0,276
2007-04-10,4,Tuesday,April,2007,False,4,280
2007-04-11,5,Wednesday,April,2007,False,5,285
2007-04-12,4,Thursday,April,2007,False,4,289
2007-04-13,10,Friday,April,2007,False,10,299
2007-04-14,2,Saturday,April,2007,True,2,301
2007-04-15,0,Sunday,April,2007,True,0,301
2007-04-16,7,Monday,April,2007,False,7,308
2007-04-17,0,Tuesday,April,2007,False,0,308
2007-04-18,9,Wednesday,April,2007,False,9,317
2007-04-19,5,Thursday,April,2007,False,5,322
2007-04-20,0,Friday,April,2007,False,0,322
2007-04-21,1,Saturday,April,2007,True,1,323
2007-04-22,0,Sunday,April,2007,True,0,323
2007-04-23,0,Monday,April,2007,False,0,323
2007-04-24,8,Tuesday,April,2007,False,8,331
2007-04-25,9,Wednesday,April,2007,False,9,340
2007-04-26,3,Thursday,April,2007,False,3,343
2007-04-27,5,Friday,April,2007,False,5,348
2007-04-28,0,Saturday,April,2007,True,0,348
2007-04-29,0,Sunday,April,2007,True,0,348
2007-04-30,4,Monday,April,2007,False,4,352
2007-05-01,10,Tuesday,May,2007,False,10,362
2007-05-02,2,Wednesday,May,2007,False,2,364
2007-05-03,2,Thursday,May,2007,False,2,366
2007-05-04,4,Friday,May,2007,False,4,370
2007-05-05,,Saturday,May,2007,True,0,370
2007-05-06,,Sunday,May,2007,True,0,370
2007-05-07,,Monday,May,2007,False,0,370
2007-05-08,2,Tuesday,May,2007,False,2,372
2007-05-09,,Wednesday,May,2007,False,0,372
2007-05-10,4,Thursday,May,2007,False,4,376
2007-05-11,1,Friday,May,2007,False,1,377
2007-05-12,,Saturday,May,2007,True,0,377
2007-05-13,,Sunday,May,2007,True,0,377
2007-05-14,,Monday,May,2007,False,0,377
2007-05-15,4,Tuesday,May,2007,False,4,381
2007-05-16,0,Wednesday,May,2007,False,0,381
2007-05-17,4,Thursday,May,2007,False,4,385
2007-05-18,4,Friday,May,2007,False,4,389
2007-05-19,0,Saturday,May,2007,True,0,389
2007-05-20,0,Sunday,May,2007,True,0,389
2007-05-21,2,Monday,May,2007,False,2,391
2007-05-22,2,Tuesday,May,2007,False,2,393
2007-05-23,5,Wednesday,May,2007,False,5,398
2007-05-24,6,Thursday,May,2007,False,6,404
2007-05-25,13,Friday,May,2007,False,13,417
2007-05-26,1,Saturday,May,2007,True,1,418
2007-05-27,1,Sunday,May,2007,True,1,419
2007-05-28,4,Monday,May,2007,False,4,423
2007-05-29,0,Tuesday,May,2007,False,0,423
2007-05-30,6,Wednesday,May,2007,False,6,429
2007-05-31,4,Thursday,May,2007,False,4,433
2007-06-01,5,Friday,June,2007,False,5,438
2007-06-02,1,Saturday,June,2007,True,1,439
2007-06-03,0,Sunday,June,2007,True,0,439
2007-06-04,5,Monday,June,2007,False,5,444
2007-06-05,6,Tuesday,June,2007,False,6,450
2007-06-06,5,Wednesday,June,2007,False,5,455
2007-06-07,6,Thursday,June,2007,False,6,461
2007-06-08,6,Friday,June,2007,False,6,467
2007-06-09,2,Saturday,June,2007,True,2,469
2007-06-10,0,Sunday,June,2007,True,0,469
2007-06-11,6,Monday,June,2007,False,6,475
2007-06-12,2,Tuesday,June,2007,False,2,477
2007-06-13,5,Wednesday,June,2007,False,5,482
2007-06-14,3,Thursday,June,2007,False,3,485
2007-06-15,2,Friday,June,2007,False,2,487
2007-06-16,0,Saturday,June,2007,True,0,487
2007-06-17,0,Sunday,June,2007,True,0,487
2007-06-18,3,Monday,June,2007,False,3,490
2007-06-19,6,Tuesday,June,2007,False,6,496
2007-06-20,10,Wednesday,June,2007,False,10,506
2007-06-21,5,Thursday,June,2007,False,5,511
2007-06-22,3,Friday,June,2007,False,3,514
2007-06-23,0,Saturday,June,2007,True,0,514
2007-06-24,1,Sunday,June,2007,True,1,515
2007-06-25,9,Monday,June,2007,False,9,524
2007-06-26,0,Tuesday,June,2007,False,0,524
2007-06-27,7,Wednesday,June,2007,False,7,531
2007-06-28,5,Thursday,June,2007,False,5,536
2007-06-29,3,Friday,June,2007,False,3,539
2007-06-30,0,Saturday,June,2007,True,0,539
2007-07-01,,Sunday,July,2007,True,0,539
2007-07-02,7,Monday,July,2007,False,7,546
2007-07-03,7,Tuesday,July,2007,False,7,553
2007-07-04,3,Wednesday,July,2007,False,3,556
2007-07-05,1,Thursday,July,2007,False,1,557
2007-07-06,6,Friday,July,2007,False,6,563
2007-07-07,1,Saturday,July,2007,True,1,564
2007-07-08,0,Sunday,July,2007,True,0,564
2007-07-09,9,Monday,July,2007,False,9,573
2007-07-10,2,Tuesday,July,2007,False,2,575
2007-07-11,8,Wednesday,July,2007,False,8,583
2007-07-12,2,Thursday,July,2007,False,2,585
2007-07-13,4,Friday,July,2007,False,4,589
2007-07-14,3,Saturday,July,2007,True,3,592
2007-07-15,0,Sunday,July,2007,True,0,592
2007-07-16,1,Monday,July,2007,False,1,593
2007-07-17,10,Tuesday,July,2007,False,10,603
2007-07-18,7,Wednesday,July,2007,False,7,610
2007-07-19,5,Thursday,July,2007,False,5,615
2007-07-20,5,Friday,July,2007,False,5,620
2007-07-21,0,Saturday,July,2007,True,0,620
2007-07-22,1,Sunday,July,2007,True,1,621
2007-07-23,8,Monday,July,2007,False,8,629
2007-07-24,0,Tuesday,July,2007,False,0,629
2007-07-25,4,Wednesday,July,2007,False,4,633
2007-07-26,6,Thursday,July,2007,False,6,639
2007-07-27,5,Friday,July,2007,False,5,644
2007-07-28,0,Saturday,July,2007,True,0,644
2007-07-29,1,Sunday,July,2007,True,1,645
2007-07-30,5,Monday,July,2007,False,5,650
2007-07-31,7,Tuesday,July,2007,False,7,657
2007-08-01,5,Wednesday,August,2007,False,5,662
2007-08-02,3,Thursday,August,2007,False,3,665
2007-08-03,4,Friday,August,2007,False,4,669
2007-08-04,0,Saturday,August,2007,True,0,669
2007-08-05,3,Sunday,August,2007,True,3,672
2007-08-06,5,Monday,August,2007,False,5,677
2007-08-07,7,Tuesday,August,2007,False,7,684
2007-08-08,11,Wednesday,August,2007,False,11,695
2007-08-09,6,Thursday,August,2007,False,6,701
2007-08-10,6,Friday,August,2007,False,6,707
2007-08-11,0,Saturday,August,2007,True,0,707
2007-08-12,0,Sunday,August,2007,True,0,707
2007-08-13,11,Monday,August,2007,False,11,718
2007-08-14,4,Tuesday,August,2007,False,4,722
2007-08-15,7,Wednesday,August,2007,False,7,729
2007-08-16,4,Thursday,August,2007,False,4,733
2007-08-17,7,Friday,August,2007,False,7,740
2007-08-18,1,Saturday,August,2007,True,1,741
2007-08-19,1,Sunday,August,2007,True,1,742
2007-08-20,8,Monday,August,2007,False,8,750
2007-08-21,12,Tuesday,August,2007,False,12,762
2007-08-22,11,Wednesday,August,2007,False,11,773
2007-08-23,11,Thursday,August,2007,False,11,784
2007-08-24,7,Friday,August,2007,False,7,791
2007-08-25,0,Saturday,August,2007,True,0,791
2007-08-26,2,Sunday,August,2007,True,2,793
2007-08-27,8,Monday,August,2007,False,8,801
2007-08-28,5,Tuesday,August,2007,False,5,806
2007-08-29,15,Wednesday,August,2007,False,15,821
2007-08-30,12,Thursday,August,2007,False,12,833
2007-08-31,5,Friday,August,2007,False,5,838
2007-09-01,3,Saturday,September,2007,True,3,841
2007-09-02,2,Sunday,September,2007,True,2,843
2007-09-03,2,Monday,September,2007,False,2,845
2007-09-04,12,Tuesday,September,2007,False,12,857
2007-09-05,18,Wednesday,September,2007,False,18,875
2007-09-06,7,Thursday,September,2007,False,7,882
2007-09-07,6,Friday,September,2007,False,6,888
2007-09-08,2,Saturday,September,2007,True,2,890
2007-09-09,4,Sunday,September,2007,True,4,894
2007-09-10,9,Monday,September,2007,False,9,903
2007-09-11,5,Tuesday,September,2007,False,5,908
2007-09-12,7,Wednesday,September,2007,False,7,915
2007-09-13,3,Thursday,September,2007,False,3,918
2007-09-14,8,Friday,September,2007,False,8,926
2007-09-15,1,Saturday,September,2007,True,1,927
2007-09-16,1,Sunday,September,2007,True,1,928
2007-09-17,1,Monday,September,2007,False,1,929
2007-09-18,5,Tuesday,September,2007,False,5,934
2007-09-19,14,Wednesday,September,2007,False,14,948
2007-09-20,18,Thursday,September,2007,False,18,966
2007-09-21,5,Friday,September,2007,False,5,971
2007-09-22,1,Saturday,September,2007,True,1,972
2007-09-23,2,Sunday,September,2007,True,2,974
2007-09-24,15,Monday,September,2007,False,15,989
2007-09-25,6,Tuesday,September,2007,False,6,995
2007-09-26,11,Wednesday,September,2007,False,11,1006
2007-09-27,5,Thursday,September,2007,False,5,1011
2007-09-28,13,Friday,September,2007,False,13,1024
2007-09-29,3,Saturday,September,2007,True,3,1027
2007-09-30,2,Sunday,September,2007,True,2,1029
2007-10-01,5,Monday,October,2007,False,5,1034
2007-10-02,17,Tuesday,October,2007,False,17,1051
2007-10-03,11,Wednesday,October,2007,False,11,1062
2007-10-04,15,Thursday,October,2007,False,15,1077
2007-10-05,11,Friday,October,2007,False,11,1088
2007-10-06,2,Saturday,October,2007,True,2,1090
2007-10-07,0,Sunday,October,2007,True,0,1090
2007-10-08,19,Monday,October,2007,False,19,1109
2007-10-09,4,Tuesday,October,2007,False,4,1113
2007-10-10,20,Wednesday,October,2007,False,20,1133
2007-10-11,5,Thursday,October,2007,False,5,1138
2007-10-12,3,Friday,October,2007,False,3,1141
2007-10-13,1,Saturday,October,2007,True,1,1142
2007-10-14,0,Sunday,October,2007,True,0,1142
2007-10-15,10,Monday,October,2007,False,10,1152
2007-10-16,6,Tuesday,October,2007,False,6,1158
2007-10-17,4,Wednesday,October,2007,False,4,1162
2007-10-18,2,Thursday,October,2007,False,2,1164
2007-10-19,10,Friday,October,2007,False,10,1174
2007-10-20,0,Saturday,October,2007,True,0,1174
2007-10-21,4,Sunday,October,2007,True,4,1178
2007-10-22,14,Monday,October,2007,False,14,1192
2007-10-23,16,Tuesday,October,2007,False,16,1208
2007-10-24,15,Wednesday,October,2007,False,15,1223
2007-10-25,6,Thursday,October,2007,False,6,1229
2007-10-26,10,Friday,October,2007,False,10,1239
2007-10-27,3,Saturday,October,2007,True,3,1242
2007-10-28,6,Sunday,October,2007,True,6,1248
2007-10-29,15,Monday,October,2007,False,15,1263
2007-10-30,11,Tuesday,October,2007,False,11,1274
2007-10-31,12,Wednesday,October,2007,False,12,1286
2007-11-01,23,Thursday,November,2007,False,23,1309
2007-11-02,4,Friday,November,2007,False,4,1313
2007-11-03,1,Saturday,November,2007,True,1,1314
2007-11-04,0,Sunday,November,2007,True,0,1314
2007-11-05,11,Monday,November,2007,False,11,1325
2007-11-06,7,Tuesday,November,2007,False,7,1332
2007-11-07,22,Wednesday,November,2007,False,22,1354
2007-11-08,8,Thursday,November,2007,False,8,1362
2007-11-09,12,Friday,November,2007,False,12,1374
2007-11-10,2,Saturday,November,2007,True,2,1376
2007-11-11,0,Sunday,November,2007,True,0,1376
2007-11-12,14,Monday,November,2007,False,14,1390
2007-11-13,7,Tuesday,November,2007,False,7,1397
2007-11-14,16,Wednesday,November,2007,False,16,1413
2007-11-15,8,Thursday,November,2007,False,8,1421
2007-11-16,4,Friday,November,2007,False,4,1425
2007-11-17,0,Saturday,November,2007,True,0,1425
2007-11-18,1,Sunday,November,2007,True,1,1426
2007-11-19,21,Monday,November,2007,False,21,1447
2007-11-20,10,Tuesday,November,2007,False,10,1457
2007-11-21,4,Wednesday,November,2007,False,4,1461
2007-11-22,15,Thursday,November,2007,False,15,1476
2007-11-23,8,Friday,November,2007,False,8,1484
2007-11-24,0,Saturday,November,2007,True,0,1484
2007-11-25,4,Sunday,November,2007,True,4,1488
2007-11-26,8,Monday,November,2007,False,8,1496
2007-11-27,10,Tuesday,November,2007,False,10,1506
2007-11-28,24,Wednesday,November,2007,False,24,1530
2007-11-29,14,Thursday,November,2007,False,14,1544
2007-11-30,8,Friday,November,2007,False,8,1552
2007-12-01,4,Saturday,December,2007,True,4,1556
2007-12-02,0,Sunday,December,2007,True,0,1556
2007-12-03,11,Monday,December,2007,False,11,1567
2007-12-04,13,Tuesday,December,2007,False,13,1580
2007-12-05,12,Wednesday,December,2007,False,12,1592
2007-12-06,7,Thursday,December,2007,False,7,1599
2007-12-07,7,Friday,December,2007,False,7,1606
2007-12-08,1,Saturday,December,2007,True,1,1607
2007-12-09,1,Sunday,December,2007,True,1,1608
2007-12-10,11,Monday,December,2007,False,11,1619
2007-12-11,13,Tuesday,December,2007,False,13,1632
2007-12-12,14,Wednesday,December,2007,False,14,1646
2007-12-13,11,Thursday,December,2007,False,11,1657
2007-12-14,8,Friday,December,2007,False,8,1665
2007-12-15,0,Saturday,December,2007,True,0,1665
2007-12-16,1,Sunday,December,2007,True,1,1666
2007-12-17,10,Monday,December,2007,False,10,1676
2007-12-18,9,Tuesday,December,2007,False,9,1685
2007-12-19,10,Wednesday,December,2007,False,10,1695
2007-12-20,4,Thursday,December,2007,False,4,1699
2007-12-21,9,Friday,December,2007,False,9,1708
2007-12-22,1,Saturday,December,2007,True,1,1709
2007-12-23,0,Sunday,December,2007,True,0,1709
2007-12-24,13,Monday,December,2007,False,13,1722
2007-12-25,0,Tuesday,December,2007,False,0,1722
2007-12-26,0,Wednesday,December,2007,False,0,1722
2007-12-27,6,Thursday,December,2007,False,6,1728
2007-12-28,2,Friday,December,2007,False,2,1730
2007-12-29,1,Saturday,December,2007,True,1,1731
2007-12-30,0,Sunday,December,2007,True,0,1731
2007-12-31,5,Monday,December,2007,False,5,1736
2008-01-01,90,Tuesday,January,2008,False,90,1826
2008-01-02,20,Wednesday,January,2008,False,20,1846
2008-01-03,19,Thursday,January,2008,False,19,1865
2008-01-04,13,Friday,January,2008,False,13,1878
2008-01-05,4,Saturday,January,2008,True,4,1882
2008-01-06,0,Sunday,January,2008,True,0,1882
2008-01-07,19,Monday,January,2008,False,19,1901
2008-01-08,125,Tuesday,January,2008,False,125,2026
2008-01-09,30,Wednesday,January,2008,False,30,2056
2008-01-10,26,Thursday,January,2008,False,26,2082
2008-01-11,6,Friday,January,2008,False,6,2088
2008-01-12,3,Saturday,January,2008,True,3,2091
2008-01-13,0,Sunday,January,2008,True,0,2091
2008-01-14,21,Monday,January,2008,False,21,2112
2008-01-15,29,Tuesday,January,2008,False,29,2141
2008-01-16,29,Wednesday,January,2008,False,29,2170
2008-01-17,24,Thursday,January,2008,False,24,2194
2008-01-18,11,Friday,January,2008,False,11,2205
2008-01-19,2,Saturday,January,2008,True,2,2207
2008-01-20,3,Sunday,January,2008,True,3,2210
2008-01-21,14,Monday,January,2008,False,14,2224
2008-01-22,20,Tuesday,January,2008,False,20,2244
2008-01-23,18,Wednesday,January,2008,False,18,2262
2008-01-24,13,Thursday,January,2008,False,13,2275
2008-01-25,9,Friday,January,2008,False,9,2284
2008-01-26,0,Saturday,January,2008,True,0,2284
2008-01-27,0,Sunday,January,2008,True,0,2284
2008-01-28,10,Monday,January,2008,False,10,2294
2008-01-29,15,Tuesday,January,2008,False,15,2309
2008-01-30,17,Wednesday,January,2008,False,17,2326
2008-01-31,8,Thursday,January,2008,False,8,2334
2008-02-01,15,Friday,February,2008,False,15,2349
2008-02-02,0,Saturday,February,2008,True,0,2349
2008-02-03,0,Sunday,February,2008,True,0,2349
2008-02-04,9,Monday,February,2008,False,9,2358
2008-02-05,35,Tuesday,February,2008,False,35,2393
2008-02-06,17,Wednesday,February,2008,False,17,2410
2008-02-07,16,Thursday,February,2008,False,16,2426
2008-02-08,12,Friday,February,2008,False,12,2438
2008-02-09,1,Saturday,February,2008,True,1,2439
2008-02-10,2,Sunday,February,2008,True,2,2441
2008-02-11,22,Monday,February,2008,False,22,2463
2008-02-12,13,Tuesday,February,2008,False,13,2476
2008-02-13,14,Wednesday,February,2008,False,14,2490
2008-02-14,18,Thursday,February,2008,False,18,2508
2008-02-15,16,Friday,February,2008,False,16,2524
2008-02-16,2,Saturday,February,2008,True,2,2526
2008-02-17,2,Sunday,February,2008,True,2,2528
2008-02-18,12,Monday,February,2008,False,12,2540
2008-02-19,18,Tuesday,February,2008,False,18,2558
2008-02-20,23,Wednesday,February,2008,False,23,2581
2008-02-21,10,Thursday,February,2008,False,10,2591
2008-02-22,17,Friday,February,2008,False,17,2608
2008-02-23,2,Saturday,February,2008,True,2,2610
2008-02-24,2,Sunday,February,2008,True,2,2612
2008-02-25,15,Monday,February,2008,False,15,2627
2008-02-26,19,Tuesday,February,2008,False,19,2646
2008-02-27,18,Wednesday,February,2008,False,18,2664
2008-02-28,13,Thursday,February,2008,False,13,2677
2008-02-29,12,Friday,February,2008,False,12,2689
2008-03-01,3,Saturday,March,2008,True,3,2692
2008-03-02,1,Sunday,March,2008,True,1,2693
2008-03-03,12,Monday,March,2008,False,12,2705
2008-03-04,9,Tuesday,March,2008,False,9,2714
2008-03-05,25,Wednesday,March,2008,False,25,2739
2008-03-06,10,Thursday,March,2008,False,10,2749
2008-03-07,10,Friday,March,2008,False,10,2759
2008-03-08,1,Saturday,March,2008,True,1,2760
2008-03-09,5,Sunday,March,2008,True,5,2765
2008-03-10,11,Monday,March,2008,False,11,2776
2008-03-11,14,Tuesday,March,2008,False,14,2790
2008-03-12,18,Wednesday,March,2008,False,18,2808
2008-03-13,8,Thursday,March,2008,False,8,2816
2008-03-14,15,Friday,March,2008,False,15,2831
2008-03-15,1,Saturday,March,2008,True,1,2832
2008-03-16,2,Sunday,March,2008,True,2,2834
2008-03-17,15,Monday,March,2008,False,15,2849
2008-03-18,8,Tuesday,March,2008,False,8,2857
2008-03-19,10,Wednesday,March,2008,False,10,2867
2008-03-20,12,Thursday,March,2008,False,12,2879
2008-03-21,1,Friday,March,2008,False,1,2880
2008-03-22,,Saturday,March,2008,True,0,2880
2008-03-23,1,Sunday,March,2008,True,1,2881
2008-03-24,2,Monday,March,2008,False,2,2883
2008-03-25,10,Tuesday,March,2008,False,10,2893
2008-03-26,26,Wednesday,March,2008,False,26,2919
2008-03-27,13,Thursday,March,2008,False,13,2932
2008-03-28,9,Friday,March,2008,False,9,2941
2008-03-29,1,Saturday,March,2008,True,1,2942
2008-03-30,0,Sunday,March,2008,True,0,2942
2008-03-31,8,Monday,March,2008,False,8,2950
2008-04-01,11,Tuesday,April,2008,False,11,2961
2008-04-02,23,Wednesday,April,2008,False,23,2984
2008-04-03,17,Thursday,April,2008,False,17,3001
2008-04-04,8,Friday,April,2008,False,8,3009
2008-04-05,4,Saturday,April,2008,True,4,3013
2008-04-06,1,Sunday,April,2008,True,1,3014
2008-04-07,8,Monday,April,2008,False,8,3022
2008-04-08,18,Tuesday,April,2008,False,18,3040
2008-04-09,24,Wednesday,April,2008,False,24,3064
2008-04-10,9,Thursday,April,2008,False,9,3073
2008-04-11,9,Friday,April,2008,False,9,3082
2008-04-12,1,Saturday,April,2008,True,1,3083
2008-04-13,4,Sunday,April,2008,True,4,3087
2008-04-14,9,Monday,April,2008,False,9,3096
2008-04-15,12,Tuesday,April,2008,False,12,3108
2008-04-16,22,Wednesday,April,2008,False,22,3130
2008-04-17,15,Thursday,April,2008,False,15,3145
2008-04-18,6,Friday,April,2008,False,6,3151
2008-04-19,4,Saturday,April,2008,True,4,3155
2008-04-20,2,Sunday,April,2008,True,2,3157
2008-04-21,22,Monday,April,2008,False,22,3179
2008-04-22,6,Tuesday,April,2008,False,6,3185
2008-04-23,19,Wednesday,April,2008,False,19,3204
2008-04-24,9,Thursday,April,2008,False,9,3213
2008-04-25,11,Friday,April,2008,False,11,3224
2008-04-26,2,Saturday,April,2008,True,2,3226
2008-04-27,2,Sunday,April,2008,True,2,3228
2008-04-28,10,Monday,April,2008,False,10,3238
2008-04-29,11,Tuesday,April,2008,False,11,3249
2008-04-30,20,Wednesday,April,2008,False,20,3269
2008-05-01,3,Thursday,May,2008,False,3,3272
2008-05-02,4,Friday,May,2008,False,4,3276
2008-05-03,3,Saturday,May,2008,True,3,3279
2008-05-04,3,Sunday,May,2008,True,3,3282
2008-05-05,22,Monday,May,2008,False,22,3304
2008-05-06,25,Tuesday,May,2008,False,25,3329
2008-05-07,30,Wednesday,May,2008,False,30,3359
2008-05-08,8,Thursday,May,2008,False,8,3367
2008-05-09,15,Friday,May,2008,False,15,3382
2008-05-10,,Saturday,May,2008,True,0,3382
2008-05-11,4,Sunday,May,2008,True,4,3386
2008-05-12,21,Monday,May,2008,False,21,3407
2008-05-13,10,Tuesday,May,2008,False,10,3417
2008-05-14,9,Wednesday,May,2008,False,9,3426
2008-05-15,7,Thursday,May,2008,False,7,3433
2008-05-16,12,Friday,May,2008,False,12,3445
2008-05-17,1,Saturday,May,2008,True,1,3446
2008-05-18,5,Sunday,May,2008,True,5,3451
2008-05-19,14,Monday,May,2008,False,14,3465
2008-05-20,19,Tuesday,May,2008,False,19,3484
2008-05-21,15,Wednesday,May,2008,False,15,3499
2008-05-22,14,Thursday,May,2008,False,14,3513
2008-05-23,8,Friday,May,2008,False,8,3521
2008-05-24,2,Saturday,May,2008,True,2,3523
2008-05-25,4,Sunday,May,2008,True,4,3527
2008-05-26,8,Monday,May,2008,False,8,3535
2008-05-27,14,Tuesday,May,2008,False,14,3549
2008-05-28,23,Wednesday,May,2008,False,23,3572
2008-05-29,10,Thursday,May,2008,False,10,3582
2008-05-30,10,Friday,May,2008,False,10,3592
2008-05-31,,Saturday,May,2008,True,0,3592
2008-06-01,3,Sunday,June,2008,True,3,3595
2008-06-02,9,Monday,June,2008,False,9,3604
2008-06-03,16,Tuesday,June,2008,False,16,3620
2008-06-04,12,Wednesday,June,2008,False,12,3632
2008-06-05,16,Thursday,June,2008,False,16,3648
2008-06-06,5,Friday,June,2008,False,5,3653
2008-06-07,6,Saturday,June,2008,True,6,3659
2008-06-08,0,Sunday,June,2008,True,0,3659
2008-06-09,9,Monday,June,2008,False,9,3668
2008-06-10,13,Tuesday,June,2008,False,13,3681
2008-06-11,29,Wednesday,June,2008,False,29,3710
2008-06-12,8,Thursday,June,2008,False,8,3718
2008-06-13,13,Friday,June,2008,False,13,3731
2008-06-14,,Saturday,June,2008,True,0,3731
2008-06-15,2,Sunday,June,2008,True,2,3733
2008-06-16,19,Monday,June,2008,False,19,3752
2008-06-17,7,Tuesday,June,2008,False,7,3759
2008-06-18,24,Wednesday,June,2008,False,24,3783
2008-06-19,6,Thursday,June,2008,False,6,3789
2008-06-20,9,Friday,June,2008,False,9,3798
2008-06-21,1,Saturday,June,2008,True,1,3799
2008-06-22,7,Sunday,June,2008,True,7,3806
2008-06-23,19,Monday,June,2008,False,19,3825
2008-06-24,12,Tuesday,June,2008,False,12,3837
2008-06-25,17,Wednesday,June,2008,False,17,3854
2008-06-26,13,Thursday,June,2008,False,13,3867
2008-06-27,7,Friday,June,2008,False,7,3874
2008-06-28,0,Saturday,June,2008,True,0,3874
2008-06-29,3,Sunday,June,2008,True,3,3877
2008-06-30,11,Monday,June,2008,False,11,3888
2008-07-01,15,Tuesday,July,2008,False,15,3903
2008-07-02,12,Wednesday,July,2008,False,12,3915
2008-07-03,7,Thursday,July,2008,False,7,3922
2008-07-04,12,Friday,July,2008,False,12,3934
2008-07-05,3,Saturday,July,2008,True,3,3937
2008-07-06,2,Sunday,July,2008,True,2,3939
2008-07-07,9,Monday,July,2008,False,9,3948
2008-07-08,14,Tuesday,July,2008,False,14,3962
2008-07-09,3,Wednesday,July,2008,False,3,3965
2008-07-10,15,Thursday,July,2008,False,15,3980
2008-07-11,20,Friday,July,2008,False,20,4000
2008-07-12,4,Saturday,July,2008,True,4,4004
2008-07-13,3,Sunday,July,2008,True,3,4007
2008-07-14,15,Monday,July,2008,False,15,4022
2008-07-15,11,Tuesday,July,2008,False,11,4033
2008-07-16,26,Wednesday,July,2008,False,26,4059
2008-07-17,20,Thursday,July,2008,False,20,4079
2008-07-18,8,Friday,July,2008,False,8,4087
2008-07-19,2,Saturday,July,2008,True,2,4089
2008-07-20,0,Sunday,July,2008,True,0,4089
2008-07-21,19,Monday,July,2008,False,19,4108
2008-07-22,14,Tuesday,July,2008,False,14,4122
2008-07-23,8,Wednesday,July,2008,False,8,4130
2008-07-24,18,Thursday,July,2008,False,18,4148
2008-07-25,10,Friday,July,2008,False,10,4158
2008-07-26,3,Saturday,July,2008,True,3,4161
2008-07-27,2,Sunday,July,2008,True,2,4163
2008-07-28,13,Monday,July,2008,False,13,4176
2008-07-29,9,Tuesday,July,2008,False,9,4185
2008-07-30,17,Wednesday,July,2008,False,17,4202
2008-07-31,16,Thursday,July,2008,False,16,4218
2008-08-01,3,Friday,August,2008,False,3,4221
2008-08-02,1,Saturday,August,2008,True,1,4222
2008-08-03,5,Sunday,August,2008,True,5,4227
2008-08-04,16,Monday,August,2008,False,16,4243
2008-08-05,19,Tuesday,August,2008,False,19,4262
2008-08-06,22,Wednesday,August,2008,False,22,4284
2008-08-07,14,Thursday,August,2008,False,14,4298
2008-08-08,8,Friday,August,2008,False,8,4306
2008-08-09,1,Saturday,August,2008,True,1,4307
2008-08-10,1,Sunday,August,2008,True,1,4308
2008-08-11,20,Monday,August,2008,False,20,4328
2008-08-12,15,Tuesday,August,2008,False,15,4343
2008-08-13,29,Wednesday,August,2008,False,29,4372
2008-08-14,16,Thursday,August,2008,False,16,4388
2008-08-15,6,Friday,August,2008,False,6,4394
2008-08-16,3,Saturday,August,2008,True,3,4397
2008-08-17,1,Sunday,August,2008,True,1,4398
2008-08-18,11,Monday,August,2008,False,11,4409
2008-08-19,27,Tuesday,August,2008,False,27,4436
2008-08-20,21,Wednesday,August,2008,False,21,4457
2008-08-21,9,Thursday,August,2008,False,9,4466
2008-08-22,7,Friday,August,2008,False,7,4473
2008-08-23,0,Saturday,August,2008,True,0,4473
2008-08-24,2,Sunday,August,2008,True,2,4475
2008-08-25,21,Monday,August,2008,False,21,4496
2008-08-26,23,Tuesday,August,2008,False,23,4519
2008-08-27,12,Wednesday,August,2008,False,12,4531
2008-08-28,18,Thursday,August,2008,False,18,4549
2008-08-29,7,Friday,August,2008,False,7,4556
2008-08-30,3,Saturday,August,2008,True,3,4559
2008-08-31,1,Sunday,August,2008,True,1,4560
2008-09-01,9,Monday,September,2008,False,9,4569
2008-09-02,12,Tuesday,September,2008,False,12,4581
2008-09-03,26,Wednesday,September,2008,False,26,4607
2008-09-04,13,Thursday,September,2008,False,13,4620
2008-09-05,10,Friday,September,2008,False,10,4630
2008-09-06,0,Saturday,September,2008,True,0,4630
2008-09-07,1,Sunday,September,2008,True,1,4631
2008-09-08,18,Monday,September,2008,False,18,4649
2008-09-09,20,Tuesday,September,2008,False,20,4669
2008-09-10,11,Wednesday,September,2008,False,11,4680
2008-09-11,28,Thursday,September,2008,False,28,4708
2008-09-12,4,Friday,September,2008,False,4,4712
2008-09-13,3,Saturday,September,2008,True,3,4715
2008-09-14,2,Sunday,September,2008,True,2,4717
2008-09-15,13,Monday,September,2008,False,13,4730
2008-09-16,12,Tuesday,September,2008,False,12,4742
2008-09-17,10,Wednesday,September,2008,False,10,4752
2008-09-18,19,Thursday,September,2008,False,19,4771
2008-09-19,7,Friday,September,2008,False,7,4778
2008-09-20,0,Saturday,September,2008,True,0,4778
2008-09-21,2,Sunday,September,2008,True,2,4780
2008-09-22,16,Monday,September,2008,False,16,4796
2008-09-23,26,Tuesday,September,2008,False,26,4822
2008-09-24,4,Wednesday,September,2008,False,4,4826
2008-09-25,10,Thursday,September,2008,False,10,4836
2008-09-26,8,Friday,September,2008,False,8,4844
2008-09-27,4,Saturday,September,2008,True,4,4848
2008-09-28,0,Sunday,September,2008,True,0,4848
2008-09-29,7,Monday,September,2008,False,7,4855
2008-09-30,10,Tuesday,September,2008,False,10,4865
2008-10-01,10,Wednesday,October,2008,False,10,4875
2008-10-02,21,Thursday,October,2008,False,21,4896
2008-10-03,12,Friday,October,2008,False,12,4908
2008-10-04,0,Saturday,October,2008,True,0,4908
2008-10-05,3,Sunday,October,2008,True,3,4911
2008-10-06,11,Monday,October,2008,False,11,4922
2008-10-07,12,Tuesday,October,2008,False,12,4934
2008-10-08,28,Wednesday,October,2008,False,28,4962
2008-10-09,8,Thursday,October,2008,False,8,4970
2008-10-10,16,Friday,October,2008,False,16,4986
2008-10-11,3,Saturday,October,2008,True,3,4989
2008-10-12,6,Sunday,October,2008,True,6,4995
2008-10-13,24,Monday,October,2008,False,24,5019
2008-10-14,27,Tuesday,October,2008,False,27,5046
2008-10-15,17,Wednesday,October,2008,False,17,5063
2008-10-16,16,Thursday,October,2008,False,16,5079
2008-10-17,6,Friday,October,2008,False,6,5085
2008-10-18,5,Saturday,October,2008,True,5,5090
2008-10-19,2,Sunday,October,2008,True,2,5092
2008-10-20,11,Monday,October,2008,False,11,5103
2008-10-21,17,Tuesday,October,2008,False,17,5120
2008-10-22,22,Wednesday,October,2008,False,22,5142
2008-10-23,16,Thursday,October,2008,False,16,5158
2008-10-24,7,Friday,October,2008,False,7,5165
2008-10-25,7,Saturday,October,2008,True,7,5172
2008-10-26,5,Sunday,October,2008,True,5,5177
2008-10-27,15,Monday,October,2008,False,15,5192
2008-10-28,17,Tuesday,October,2008,False,17,5209
2008-10-29,16,Wednesday,October,2008,False,16,5225
2008-10-30,16,Thursday,October,2008,False,16,5241
2008-10-31,6,Friday,October,2008,False,6,5247
2008-11-01,0,Saturday,November,2008,True,0,5247
2008-11-02,0,Sunday,November,2008,True,0,5247
2008-11-03,15,Monday,November,2008,False,15,5262
2008-11-04,7,Tuesday,November,2008,False,7,5269
2008-11-05,13,Wednesday,November,2008,False,13,5282
2008-11-06,17,Thursday,November,2008,False,17,5299
2008-11-07,14,Friday,November,2008,False,14,5313
2008-11-08,0,Saturday,November,2008,True,0,5313
2008-11-09,2,Sunday,November,2008,True,2,5315
2008-11-10,11,Monday,November,2008,False,11,5326
2008-11-11,21,Tuesday,November,2008,False,21,5347
2008-11-12,11,Wednesday,November,2008,False,11,5358
2008-11-13,10,Thursday,November,2008,False,10,5368
2008-11-14,5,Friday,November,2008,False,5,5373
2008-11-15,0,Saturday,November,2008,True,0,5373
2008-11-16,1,Sunday,November,2008,True,1,5374
2008-11-17,12,Monday,November,2008,False,12,5386
2008-11-18,17,Tuesday,November,2008,False,17,5403
2008-11-19,17,Wednesday,November,2008,False,17,5420
2008-11-20,18,Thursday,November,2008,False,18,5438
2008-11-21,11,Friday,November,2008,False,11,5449
2008-11-22,4,Saturday,November,2008,True,4,5453
2008-11-23,0,Sunday,November,2008,True,0,5453
2008-11-24,13,Monday,November,2008,False,13,5466
2008-11-25,7,Tuesday,November,2008,False,7,5473
2008-11-26,11,Wednesday,November,2008,False,11,5484
2008-11-27,12,Thursday,November,2008,False,12,5496
2008-11-28,6,Friday,November,2008,False,6,5502
2008-11-29,1,Saturday,November,2008,True,1,5503
2008-11-30,1,Sunday,November,2008,True,1,5504
2008-12-01,9,Monday,December,2008,False,9,5513
2008-12-02,12,Tuesday,December,2008,False,12,5525
2008-12-03,4,Wednesday,December,2008,False,4,5529
2008-12-04,17,Thursday,December,2008,False,17,5546
2008-12-05,5,Friday,December,2008,False,5,5551
2008-12-06,0,Saturday,December,2008,True,0,5551
2008-12-07,1,Sunday,December,2008,True,1,5552
2008-12-08,9,Monday,December,2008,False,9,5561
2008-12-09,3,Tuesday,December,2008,False,3,5564
2008-12-10,17,Wednesday,December,2008,False,17,5581
2008-12-11,20,Thursday,December,2008,False,20,5601
2008-12-12,7,Friday,December,2008,False,7,5608
2008-12-13,1,Saturday,December,2008,True,1,5609
2008-12-14,1,Sunday,December,2008,True,1,5610
2008-12-15,20,Monday,December,2008,False,20,5630
2008-12-16,13,Tuesday,December,2008,False,13,5643
2008-12-17,12,Wednesday,December,2008,False,12,5655
2008-12-18,12,Thursday,December,2008,False,12,5667
2008-12-19,10,Friday,December,2008,False,10,5677
2008-12-20,0,Saturday,December,2008,True,0,5677
2008-12-21,0,Sunday,December,2008,True,0,5677
2008-12-22,9,Monday,December,2008,False,9,5686
2008-12-23,1,Tuesday,December,2008,False,1,5687
2008-12-24,3,Wednesday,December,2008,False,3,5690
2008-12-25,0,Thursday,December,2008,False,0,5690
2008-12-26,0,Friday,December,2008,False,0,5690
2008-12-27,2,Saturday,December,2008,True,2,5692
2008-12-28,0,Sunday,December,2008,True,0,5692
2008-12-29,5,Monday,December,2008,False,5,5697
2008-12-30,7,Tuesday,December,2008,False,7,5704
2008-12-31,6,Wednesday,December,2008,False,6,5710
2009-01-01,94,Thursday,January,2009,False,94,5804
2009-01-02,3,Friday,January,2009,False,3,5807
2009-01-03,2,Saturday,January,2009,True,2,5809
2009-01-04,,Sunday,January,2009,True,0,5809
2009-01-05,50,Monday,January,2009,False,50,5859
2009-01-06,130,Tuesday,January,2009,False,130,5989
2009-01-07,21,Wednesday,January,2009,False,21,6010
2009-01-08,16,Thursday,January,2009,False,16,6026
2009-01-09,8,Friday,January,2009,False,8,6034
2009-01-10,1,Saturday,January,2009,True,1,6035
2009-01-11,0,Sunday,January,2009,True,0,6035
2009-01-12,14,Monday,January,2009,False,14,6049
2009-01-13,28,Tuesday,January,2009,False,28,6077
2009-01-14,24,Wednesday,January,2009,False,24,6101
2009-01-15,27,Thursday,January,2009,False,27,6128
2009-01-16,6,Friday,January,2009,False,6,6134
2009-01-17,3,Saturday,January,2009,True,3,6137
2009-01-18,,Sunday,January,2009,True,0,6137
2009-01-19,13,Monday,January,2009,False,13,6150
2009-01-20,35,Tuesday,January,2009,False,35,6185
2009-01-21,20,Wednesday,January,2009,False,20,6205
2009-01-22,28,Thursday,January,2009,False,28,6233
2009-01-23,5,Friday,January,2009,False,5,6238
2009-01-24,1,Saturday,January,2009,True,1,6239
2009-01-25,0,Sunday,January,2009,True,0,6239
2009-01-26,13,Monday,January,2009,False,13,6252
2009-01-27,21,Tuesday,January,2009,False,21,6273
2009-01-28,5,Wednesday,January,2009,False,5,6278
2009-01-29,12,Thursday,January,2009,False,12,6290
2009-01-30,8,Friday,January,2009,False,8,6298
2009-01-31,2,Saturday,January,2009,True,2,6300
2009-02-01,2,Sunday,February,2009,True,2,6302
2009-02-02,16,Monday,February,2009,False,16,6318
2009-02-03,37,Tuesday,February,2009,False,37,6355
2009-02-04,20,Wednesday,February,2009,False,20,6375
2009-02-05,8,Thursday,February,2009,False,8,6383
2009-02-06,8,Friday,February,2009,False,8,6391
2009-02-07,1,Saturday,February,2009,True,1,6392
2009-02-08,1,Sunday,February,2009,True,1,6393
2009-02-09,11,Monday,February,2009,False,11,6404
2009-02-10,42,Tuesday,February,2009,False,42,6446
2009-02-11,20,Wednesday,February,2009,False,20,6466
2009-02-12,18,Thursday,February,2009,False,18,6484
2009-02-13,19,Friday,February,2009,False,19,6503
2009-02-14,1,Saturday,February,2009,True,1,6504
2009-02-15,2,Sunday,February,2009,True,2,6506
2009-02-16,17,Monday,February,2009,False,17,6523
2009-02-17,24,Tuesday,February,2009,False,24,6547
2009-02-18,15,Wednesday,February,2009,False,15,6562
2009-02-19,13,Thursday,February,2009,False,13,6575
2009-02-20,16,Friday,February,2009,False,16,6591
2009-02-21,0,Saturday,February,2009,True,0,6591
2009-02-22,2,Sunday,February,2009,True,2,6593
2009-02-23,21,Monday,February,2009,False,21,6614
2009-02-24,26,Tuesday,February,2009,False,26,6640
2009-02-25,11,Wednesday,February,2009,False,11,6651
2009-02-26,20,Thursday,February,2009,False,20,6671
2009-02-27,11,Friday,February,2009,False,11,6682
2009-02-28,,Saturday,February,2009,True,0,6682
2009-03-01,3,Sunday,March,2009,True,3,6685
2009-03-02,21,Monday,March,2009,False,21,6706
2009-03-03,23,Tuesday,March,2009,False,23,6729
2009-03-04,12,Wednesday,March,2009,False,12,6741
2009-03-05,5,Thursday,March,2009,False,5,6746
2009-03-06,13,Friday,March,2009,False,13,6759
2009-03-07,1,Saturday,March,2009,True,1,6760
2009-03-08,3,Sunday,March,2009,True,3,6763
2009-03-09,11,Monday,March,2009,False,11,6774
2009-03-10,34,Tuesday,March,2009,False,34,6808
2009-03-11,9,Wednesday,March,2009,False,9,6817
2009-03-12,12,Thursday,March,2009,False,12,6829
2009-03-13,10,Friday,March,2009,False,10,6839
2009-03-14,3,Saturday,March,2009,True,3,6842
2009-03-15,2,Sunday,March,2009,True,2,6844
2009-03-16,12,Monday,March,2009,False,12,6856
2009-03-17,14,Tuesday,March,2009,False,14,6870
2009-03-18,8,Wednesday,March,2009,False,8,6878
2009-03-19,9,Thursday,March,2009,False,9,6887
2009-03-20,14,Friday,March,2009,False,14,6901
2009-03-21,3,Saturday,March,2009,True,3,6904
2009-03-22,3,Sunday,March,2009,True,3,6907
2009-03-23,16,Monday,March,2009,False,16,6923
2009-03-24,15,Tuesday,March,2009,False,15,6938
2009-03-25,12,Wednesday,March,2009,False,12,6950
2009-03-26,18,Thursday,March,2009,False,18,6968
2009-03-27,14,Friday,March,2009,False,14,6982
2009-03-28,1,Saturday,March,2009,True,1,6983
2009-03-29,5,Sunday,March,2009,True,5,6988
2009-03-30,12,Monday,March,2009,False,12,7000
2009-03-31,22,Tuesday,March,2009,False,22,7022
2009-04-01,18,Wednesday,April,2009,False,18,7040
2009-04-02,16,Thursday,April,2009,False,16,7056
2009-04-03,12,Friday,April,2009,False,12,7068
2009-04-04,3,Saturday,April,2009,True,3,7071
2009-04-05,4,Sunday,April,2009,True,4,7075
2009-04-06,13,Monday,April,2009,False,13,7088
2009-04-07,14,Tuesday,April,2009,False,14,7102
2009-04-08,11,Wednesday,April,2009,False,11,7113
2009-04-09,14,Thursday,April,2009,False,14,7127
2009-04-10,4,Friday,April,2009,False,4,7131
2009-04-11,0,Saturday,April,2009,True,0,7131
2009-04-12,2,Sunday,April,2009,True,2,7133
2009-04-13,1,Monday,April,2009,False,1,7134
2009-04-14,18,Tuesday,April,2009,False,18,7152
2009-04-15,12,Wednesday,April,2009,False,12,7164
2009-04-16,14,Thursday,April,2009,False,14,7178
2009-04-17,8,Friday,April,2009,False,8,7186
2009-04-18,3,Saturday,April,2009,True,3,7189
2009-04-19,4,Sunday,April,2009,True,4,7193
2009-04-20,10,Monday,April,2009,False,10,7203
2009-04-21,16,Tuesday,April,2009,False,16,7219
2009-04-22,8,Wednesday,April,2009,False,8,7227
2009-04-23,26,Thursday,April,2009,False,26,7253
2009-04-24,7,Friday,April,2009,False,7,7260
2009-04-25,1,Saturday,April,2009,True,1,7261
2009-04-26,2,Sunday,April,2009,True,2,7263
2009-04-27,12,Monday,April,2009,False,12,7275
2009-04-28,18,Tuesday,April,2009,False,18,7293
2009-04-29,8,Wednesday,April,2009,False,8,7301
2009-04-30,12,Thursday,April,2009,False,12,7313
2009-05-01,5,Friday,May,2009,False,5,7318
2009-05-02,1,Saturday,May,2009,True,1,7319
2009-05-03,3,Sunday,May,2009,True,3,7322
2009-05-04,18,Monday,May,2009,False,18,7340
2009-05-05,15,Tuesday,May,2009,False,15,7355
2009-05-06,14,Wednesday,May,2009,False,14,7369
2009-05-07,11,Thursday,May,2009,False,11,7380
2009-05-08,12,Friday,May,2009,False,12,7392
2009-05-09,4,Saturday,May,2009,True,4,7396
2009-05-10,1,Sunday,May,2009,True,1,7397
2009-05-11,13,Monday,May,2009,False,13,7410
2009-05-12,22,Tuesday,May,2009,False,22,7432
2009-05-13,18,Wednesday,May,2009,False,18,7450
2009-05-14,11,Thursday,May,2009,False,11,7461
2009-05-15,10,Friday,May,2009,False,10,7471
2009-05-16,3,Saturday,May,2009,True,3,7474
2009-05-17,1,Sunday,May,2009,True,1,7475
2009-05-18,13,Monday,May,2009,False,13,7488
2009-05-19,12,Tuesday,May,2009,False,12,7500
2009-05-20,14,Wednesday,May,2009,False,14,7514
2009-05-21,11,Thursday,May,2009,False,11,7525
2009-05-22,15,Friday,May,2009,False,15,7540
2009-05-23,2,Saturday,May,2009,True,2,7542
2009-05-24,1,Sunday,May,2009,True,1,7543
2009-05-25,16,Monday,May,2009,False,16,7559
2009-05-26,24,Tuesday,May,2009,False,24,7583
2009-05-27,12,Wednesday,May,2009,False,12,7595
2009-05-28,20,Thursday,May,2009,False,20,7615
2009-05-29,6,Friday,May,2009,False,6,7621
2009-05-30,0,Saturday,May,2009,True,0,7621
2009-05-31,2,Sunday,May,2009,True,2,7623
2009-06-01,14,Monday,June,2009,False,14,7637
2009-06-02,18,Tuesday,June,2009,False,18,7655
2009-06-03,5,Wednesday,June,2009,False,5,7660
2009-06-04,7,Thursday,June,2009,False,7,7667
2009-06-05,11,Friday,June,2009,False,11,7678
2009-06-06,5,Saturday,June,2009,True,5,7683
2009-06-07,1,Sunday,June,2009,True,1,7684
2009-06-08,16,Monday,June,2009,False,16,7700
2009-06-09,19,Tuesday,June,2009,False,19,7719
2009-06-10,24,Wednesday,June,2009,False,24,7743
2009-06-11,17,Thursday,June,2009,False,17,7760
2009-06-12,14,Friday,June,2009,False,14,7774
2009-06-13,3,Saturday,June,2009,True,3,7777
2009-06-14,3,Sunday,June,2009,True,3,7780
2009-06-15,18,Monday,June,2009,False,18,7798
2009-06-16,36,Tuesday,June,2009,False,36,7834
2009-06-17,19,Wednesday,June,2009,False,19,7853
2009-06-18,9,Thursday,June,2009,False,9,7862
2009-06-19,6,Friday,June,2009,False,6,7868
2009-06-20,5,Saturday,June,2009,True,5,7873
2009-06-21,2,Sunday,June,2009,True,2,7875
2009-06-22,25,Monday,June,2009,False,25,7900
2009-06-23,5,Tuesday,June,2009,False,5,7905
2009-06-24,20,Wednesday,June,2009,False,20,7925
2009-06-25,9,Thursday,June,2009,False,9,7934
2009-06-26,8,Friday,June,2009,False,8,7942
2009-06-27,7,Saturday,June,2009,True,7,7949
2009-06-28,0,Sunday,June,2009,True,0,7949
2009-06-29,17,Monday,June,2009,False,17,7966
2009-06-30,22,Tuesday,June,2009,False,22,7988
2009-07-01,14,Wednesday,July,2009,False,14,8002
2009-07-02,7,Thursday,July,2009,False,7,8009
2009-07-03,7,Friday,July,2009,False,7,8016
2009-07-04,1,Saturday,July,2009,True,1,8017
2009-07-05,0,Sunday,July,2009,True,0,8017
2009-07-06,15,Monday,July,2009,False,15,8032
2009-07-07,10,Tuesday,July,2009,False,10,8042
2009-07-08,10,Wednesday,July,2009,False,10,8052
2009-07-09,22,Thursday,July,2009,False,22,8074
2009-07-10,6,Friday,July,2009,False,6,8080
2009-07-11,2,Saturday,July,2009,True,2,8082
2009-07-12,1,Sunday,July,2009,True,1,8083
2009-07-13,18,Monday,July,2009,False,18,8101
2009-07-14,32,Tuesday,July,2009,False,32,8133
2009-07-15,4,Wednesday,July,2009,False,4,8137
2009-07-16,15,Thursday,July,2009,False,15,8152
2009-07-17,3,Friday,July,2009,False,3,8155
2009-07-18,3,Saturday,July,2009,True,3,8158
2009-07-19,5,Sunday,July,2009,True,5,8163
2009-07-20,30,Monday,July,2009,False,30,8193
2009-07-21,15,Tuesday,July,2009,False,15,8208
2009-07-22,19,Wednesday,July,2009,False,19,8227
2009-07-23,12,Thursday,July,2009,False,12,8239
2009-07-24,4,Friday,July,2009,False,4,8243
2009-07-25,1,Saturday,July,2009,True,1,8244
2009-07-26,2,Sunday,July,2009,True,2,8246
2009-07-27,18,Monday,July,2009,False,18,8264
2009-07-28,14,Tuesday,July,2009,False,14,8278
2009-07-29,13,Wednesday,July,2009,False,13,8291
2009-07-30,17,Thursday,July,2009,False,17,8308
2009-07-31,11,Friday,July,2009,False,11,8319
2009-08-01,1,Saturday,August,2009,True,1,8320
2009-08-02,2,Sunday,August,2009,True,2,8322
2009-08-03,13,Monday,August,2009,False,13,8335
2009-08-04,18,Tuesday,August,2009,False,18,8353
2009-08-05,24,Wednesday,August,2009,False,24,8377
2009-08-06,16,Thursday,August,2009,False,16,8393
2009-08-07,3,Friday,August,2009,False,3,8396
2009-08-08,3,Saturday,August,2009,True,3,8399
2009-08-09,6,Sunday,August,2009,True,6,8405
2009-08-10,13,Monday,August,2009,False,13,8418
2009-08-11,26,Tuesday,August,2009,False,26,8444
2009-08-12,22,Wednesday,August,2009,False,22,8466
2009-08-13,9,Thursday,August,2009,False,9,8475
2009-08-14,12,Friday,August,2009,False,12,8487
2009-08-15,3,Saturday,August,2009,True,3,8490
2009-08-16,1,Sunday,August,2009,True,1,8491
2009-08-17,15,Monday,August,2009,False,15,8506
2009-08-18,27,Tuesday,August,2009,False,27,8533
2009-08-19,13,Wednesday,August,2009,False,13,8546
2009-08-20,25,Thursday,August,2009,False,25,8571
2009-08-21,8,Friday,August,2009,False,8,8579
2009-08-22,,Saturday,August,2009,True,0,8579
2009-08-23,1,Sunday,August,2009,True,1,8580
2009-08-24,29,Monday,August,2009,False,29,8609
2009-08-25,27,Tuesday,August,2009,False,27,8636
2009-08-26,18,Wednesday,August,2009,False,18,8654
2009-08-27,12,Thursday,August,2009,False,12,8666
2009-08-28,5,Friday,August,2009,False,5,8671
2009-08-29,0,Saturday,August,2009,True,0,8671
2009-08-30,1,Sunday,August,2009,True,1,8672
2009-08-31,10,Monday,August,2009,False,10,8682
2009-09-01,18,Tuesday,September,2009,False,18,8700
2009-09-02,19,Wednesday,September,2009,False,19,8719
2009-09-03,19,Thursday,September,2009,False,19,8738
2009-09-04,3,Friday,September,2009,False,3,8741
2009-09-05,1,Saturday,September,2009,True,1,8742
2009-09-06,3,Sunday,September,2009,True,3,8745
2009-09-07,12,Monday,September,2009,False,12,8757
2009-09-08,17,Tuesday,September,2009,False,17,8774
2009-09-09,29,Wednesday,September,2009,False,29,8803
2009-09-10,26,Thursday,September,2009,False,26,8829
2009-09-11,3,Friday,September,2009,False,3,8832
2009-09-12,0,Saturday,September,2009,True,0,8832
2009-09-13,1,Sunday,September,2009,True,1,8833
2009-09-14,18,Monday,September,2009,False,18,8851
2009-09-15,17,Tuesday,September,2009,False,17,8868
2009-09-16,25,Wednesday,September,2009,False,25,8893
2009-09-17,12,Thursday,September,2009,False,12,8905
2009-09-18,10,Friday,September,2009,False,10,8915
2009-09-19,2,Saturday,September,2009,True,2,8917
2009-09-20,3,Sunday,September,2009,True,3,8920
2009-09-21,7,Monday,September,2009,False,7,8927
2009-09-22,6,Tuesday,September,2009,False,6,8933
2009-09-23,23,Wednesday,September,2009,False,23,8956
2009-09-24,12,Thursday,September,2009,False,12,8968
2009-09-25,5,Friday,September,2009,False,5,8973
2009-09-26,0,Saturday,September,2009,True,0,8973
2009-09-27,3,Sunday,September,2009,True,3,8976
2009-09-28,26,Monday,September,2009,False,26,9002
2009-09-29,16,Tuesday,September,2009,False,16,9018
2009-09-30,21,Wednesday,September,2009,False,21,9039
2009-10-01,4,Thursday,October,2009,False,4,9043
2009-10-02,4,Friday,October,2009,False,4,9047
2009-10-03,0,Saturday,October,2009,True,0,9047
2009-10-04,3,Sunday,October,2009,True,3,9050
2009-10-05,17,Monday,October,2009,False,17,9067
2009-10-06,13,Tuesday,October,2009,False,13,9080
2009-10-07,25,Wednesday,October,2009,False,25,9105
2009-10-08,12,Thursday,October,2009,False,12,9117
2009-10-09,5,Friday,October,2009,False,5,9122
2009-10-10,2,Saturday,October,2009,True,2,9124
2009-10-11,0,Sunday,October,2009,True,0,9124
2009-10-12,27,Monday,October,2009,False,27,9151
2009-10-13,20,Tuesday,October,2009,False,20,9171
2009-10-14,20,Wednesday,October,2009,False,20,9191
2009-10-15,22,Thursday,October,2009,False,22,9213
2009-10-16,6,Friday,October,2009,False,6,9219
2009-10-17,3,Saturday,October,2009,True,3,9222
2009-10-18,5,Sunday,October,2009,True,5,9227
2009-10-19,12,Monday,October,2009,False,12,9239
2009-10-20,23,Tuesday,October,2009,False,23,9262
2009-10-21,22,Wednesday,October,2009,False,22,9284
2009-10-22,19,Thursday,October,2009,False,19,9303
2009-10-23,9,Friday,October,2009,False,9,9312
2009-10-24,4,Saturday,October,2009,True,4,9316
2009-10-25,5,Sunday,October,2009,True,5,9321
2009-10-26,12,Monday,October,2009,False,12,9333
2009-10-27,8,Tuesday,October,2009,False,8,9341
2009-10-28,19,Wednesday,October,2009,False,19,9360
2009-10-29,15,Thursday,October,2009,False,15,9375
2009-10-30,2,Friday,October,2009,False,2,9377
2009-10-31,1,Saturday,October,2009,True,1,9378
2009-11-01,3,Sunday,November,2009,True,3,9381
2009-11-02,22,Monday,November,2009,False,22,9403
2009-11-03,8,Tuesday,November,2009,False,8,9411
2009-11-04,19,Wednesday,November,2009,False,19,9430
2009-11-05,21,Thursday,November,2009,False,21,9451
2009-11-06,6,Friday,November,2009,False,6,9457
2009-11-07,1,Saturday,November,2009,True,1,9458
2009-11-08,2,Sunday,November,2009,True,2,9460
2009-11-09,21,Monday,November,2009,False,21,9481
2009-11-10,20,Tuesday,November,2009,False,20,9501
2009-11-11,13,Wednesday,November,2009,False,13,9514
2009-11-12,12,Thursday,November,2009,False,12,9526
2009-11-13,9,Friday,November,2009,False,9,9535
2009-11-14,1,Saturday,November,2009,True,1,9536
2009-11-15,1,Sunday,November,2009,True,1,9537
2009-11-16,25,Monday,November,2009,False,25,9562
2009-11-17,15,Tuesday,November,2009,False,15,9577
2009-11-18,19,Wednesday,November,2009,False,19,9596
2009-11-19,19,Thursday,November,2009,False,19,9615
2009-11-20,9,Friday,November,2009,False,9,9624
2009-11-21,0,Saturday,November,2009,True,0,9624
2009-11-22,1,Sunday,November,2009,True,1,9625
2009-11-23,10,Monday,November,2009,False,10,9635
2009-11-24,27,Tuesday,November,2009,False,27,9662
2009-11-25,17,Wednesday,November,2009,False,17,9679
2009-11-26,2,Thursday,November,2009,False,2,9681
2009-11-27,3,Friday,November,2009,False,3,9684
2009-11-28,0,Saturday,November,2009,True,0,9684
2009-11-29,0,Sunday,November,2009,True,0,9684
2009-11-30,19,Monday,November,2009,False,19,9703
2009-12-01,16,Tuesday,December,2009,False,16,9719
2009-12-02,12,Wednesday,December,2009,False,12,9731
2009-12-03,11,Thursday,December,2009,False,11,9742
2009-12-04,16,Friday,December,2009,False,16,9758
2009-12-05,1,Saturday,December,2009,True,1,9759
2009-12-06,0,Sunday,December,2009,True,0,9759
2009-12-07,9,Monday,December,2009,False,9,9768
2009-12-08,15,Tuesday,December,2009,False,15,9783
2009-12-09,12,Wednesday,December,2009,False,12,9795
2009-12-10,15,Thursday,December,2009,False,15,9810
2009-12-11,14,Friday,December,2009,False,14,9824
2009-12-12,2,Saturday,December,2009,True,2,9826
2009-12-13,0,Sunday,December,2009,True,0,9826
2009-12-14,9,Monday,December,2009,False,9,9835
2009-12-15,9,Tuesday,December,2009,False,9,9844
2009-12-16,10,Wednesday,December,2009,False,10,9854
2009-12-17,11,Thursday,December,2009,False,11,9865
2009-12-18,4,Friday,December,2009,False,4,9869
2009-12-19,0,Saturday,December,2009,True,0,9869
2009-12-20,0,Sunday,December,2009,True,0,9869
2009-12-21,20,Monday,December,2009,False,20,9889
2009-12-22,7,Tuesday,December,2009,False,7,9896
2009-12-23,5,Wednesday,December,2009,False,5,9901
2009-12-24,3,Thursday,December,2009,False,3,9904
2009-12-25,0,Friday,December,2009,False,0,9904
2009-12-26,0,Saturday,December,2009,True,0,9904
2009-12-27,0,Sunday,December,2009,True,0,9904
2009-12-28,1,Monday,December,2009,False,1,9905
2009-12-29,3,Tuesday,December,2009,False,3,9908
2009-12-30,3,Wednesday,December,2009,False,3,9911
2009-12-31,6,Thursday,December,2009,False,6,9917
2010-01-01,4,Friday,January,2010,False,4,9921
2010-01-02,2,Saturday,January,2010,True,2,9923
2010-01-03,0,Sunday,January,2010,True,0,9923
2010-01-04,7,Monday,January,2010,False,7,9930
2010-01-05,22,Tuesday,January,2010,False,22,9952
2010-01-06,13,Wednesday,January,2010,False,13,9965
2010-01-07,13,Thursday,January,2010,False,13,9978
2010-01-08,6,Friday,January,2010,False,6,9984
2010-01-09,1,Saturday,January,2010,True,1,9985
2010-01-10,2,Sunday,January,2010,True,2,9987
2010-01-11,24,Monday,January,2010,False,24,10011
2010-01-12,27,Tuesday,January,2010,False,27,10038
2010-01-13,28,Wednesday,January,2010,False,28,10066
2010-01-14,24,Thursday,January,2010,False,24,10090
2010-01-15,7,Friday,January,2010,False,7,10097
2010-01-16,,Saturday,January,2010,True,0,10097
2010-01-17,0,Sunday,January,2010,True,0,10097
2010-01-18,24,Monday,January,2010,False,24,10121
2010-01-19,19,Tuesday,January,2010,False,19,10140
2010-01-20,21,Wednesday,January,2010,False,21,10161
2010-01-21,23,Thursday,January,2010,False,23,10184
2010-01-22,4,Friday,January,2010,False,4,10188
2010-01-23,1,Saturday,January,2010,True,1,10189
2010-01-24,2,Sunday,January,2010,True,2,10191
2010-01-25,10,Monday,January,2010,False,10,10201
2010-01-26,23,Tuesday,January,2010,False,23,10224
2010-01-27,15,Wednesday,January,2010,False,15,10239
2010-01-28,22,Thursday,January,2010,False,22,10261
2010-01-29,4,Friday,January,2010,False,4,10265
2010-01-30,1,Saturday,January,2010,True,1,10266
2010-01-31,,Sunday,January,2010,True,0,10266
2010-02-01,21,Monday,February,2010,False,21,10287
2010-02-02,26,Tuesday,February,2010,False,26,10313
2010-02-03,23,Wednesday,February,2010,False,23,10336
2010-02-04,19,Thursday,February,2010,False,19,10355
2010-02-05,14,Friday,February,2010,False,14,10369
2010-02-06,0,Saturday,February,2010,True,0,10369
2010-02-07,5,Sunday,February,2010,True,5,10374
2010-02-08,14,Monday,February,2010,False,14,10388
2010-02-09,19,Tuesday,February,2010,False,19,10407
2010-02-10,21,Wednesday,February,2010,False,21,10428
2010-02-11,19,Thursday,February,2010,False,19,10447
2010-02-12,12,Friday,February,2010,False,12,10459
2010-02-13,2,Saturday,February,2010,True,2,10461
2010-02-14,1,Sunday,February,2010,True,1,10462
2010-02-15,18,Monday,February,2010,False,18,10480
2010-02-16,24,Tuesday,February,2010,False,24,10504
2010-02-17,18,Wednesday,February,2010,False,18,10522
2010-02-18,22,Thursday,February,2010,False,22,10544
2010-02-19,4,Friday,February,2010,False,4,10548
2010-02-20,2,Saturday,February,2010,True,2,10550
2010-02-21,1,Sunday,February,2010,True,1,10551
2010-02-22,26,Monday,February,2010,False,26,10577
2010-02-23,18,Tuesday,February,2010,False,18,10595
2010-02-24,22,Wednesday,February,2010,False,22,10617
2010-02-25,13,Thursday,February,2010,False,13,10630
2010-02-26,9,Friday,February,2010,False,9,10639
2010-02-27,2,Saturday,February,2010,True,2,10641
2010-02-28,,Sunday,February,2010,True,0,10641
2010-03-01,19,Monday,March,2010,False,19,10660
2010-03-02,31,Tuesday,March,2010,False,31,10691
2010-03-03,16,Wednesday,March,2010,False,16,10707
2010-03-04,15,Thursday,March,2010,False,15,10722
2010-03-05,6,Friday,March,2010,False,6,10728
2010-03-06,1,Saturday,March,2010,True,1,10729
2010-03-07,1,Sunday,March,2010,True,1,10730
2010-03-08,11,Monday,March,2010,False,11,10741
2010-03-09,16,Tuesday,March,2010,False,16,10757
2010-03-10,12,Wednesday,March,2010,False,12,10769
2010-03-11,25,Thursday,March,2010,False,25,10794
2010-03-12,3,Friday,March,2010,False,3,10797
2010-03-13,2,Saturday,March,2010,True,2,10799
2010-03-14,2,Sunday,March,2010,True,2,10801
2010-03-15,19,Monday,March,2010,False,19,10820
2010-03-16,30,Tuesday,March,2010,False,30,10850
2010-03-17,11,Wednesday,March,2010,False,11,10861
2010-03-18,13,Thursday,March,2010,False,13,10874
2010-03-19,1,Friday,March,2010,False,1,10875
2010-03-20,0,Saturday,March,2010,True,0,10875
2010-03-21,0,Sunday,March,2010,True,0,10875
2010-03-22,11,Monday,March,2010,False,11,10886
2010-03-23,22,Tuesday,March,2010,False,22,10908
2010-03-24,23,Wednesday,March,2010,False,23,10931
2010-03-25,10,Thursday,March,2010,False,10,10941
2010-03-26,5,Friday,March,2010,False,5,10946
2010-03-27,1,Saturday,March,2010,True,1,10947
2010-03-28,1,Sunday,March,2010,True,1,10948
2010-03-29,23,Monday,March,2010,False,23,10971
2010-03-30,7,Tuesday,March,2010,False,7,10978
2010-03-31,20,Wednesday,March,2010,False,20,10998
2010-04-01,19,Thursday,April,2010,False,19,11017
2010-04-02,6,Friday,April,2010,False,6,11023
2010-04-03,4,Saturday,April,2010,True,4,11027
2010-04-04,0,Sunday,April,2010,True,0,11027
2010-04-05,1,Monday,April,2010,False,1,11028
2010-04-06,7,Tuesday,April,2010,False,7,11035
2010-04-07,20,Wednesday,April,2010,False,20,11055
2010-04-08,6,Thursday,April,2010,False,6,11061
2010-04-09,9,Friday,April,2010,False,9,11070
2010-04-10,0,Saturday,April,2010,True,0,11070
2010-04-11,4,Sunday,April,2010,True,4,11074
2010-04-12,19,Monday,April,2010,False,19,11093
2010-04-13,11,Tuesday,April,2010,False,11,11104
2010-04-14,14,Wednesday,April,2010,False,14,11118
2010-04-15,11,Thursday,April,2010,False,11,11129
2010-04-16,6,Friday,April,2010,False,6,11135
2010-04-17,0,Saturday,April,2010,True,0,11135
2010-04-18,3,Sunday,April,2010,True,3,11138
2010-04-19,7,Monday,April,2010,False,7,11145
2010-04-20,11,Tuesday,April,2010,False,11,11156
2010-04-21,11,Wednesday,April,2010,False,11,11167
2010-04-22,16,Thursday,April,2010,False,16,11183
2010-04-23,9,Friday,April,2010,False,9,11192
2010-04-24,3,Saturday,April,2010,True,3,11195
2010-04-25,4,Sunday,April,2010,True,4,11199
2010-04-26,14,Monday,April,2010,False,14,11213
2010-04-27,16,Tuesday,April,2010,False,16,11229
2010-04-28,15,Wednesday,April,2010,False,15,11244
2010-04-29,11,Thursday,April,2010,False,11,11255
2010-04-30,11,Friday,April,2010,False,11,11266
2010-05-01,7,Saturday,May,2010,True,7,11273
2010-05-02,3,Sunday,May,2010,True,3,11276
2010-05-03,7,Monday,May,2010,False,7,11283
2010-05-04,20,Tuesday,May,2010,False,20,11303
2010-05-05,12,Wednesday,May,2010,False,12,11315
2010-05-06,7,Thursday,May,2010,False,7,11322
2010-05-07,3,Friday,May,2010,False,3,11325
2010-05-08,3,Saturday,May,2010,True,3,11328
2010-05-09,2,Sunday,May,2010,True,2,11330
2010-05-10,19,Monday,May,2010,False,19,11349
2010-05-11,19,Tuesday,May,2010,False,19,11368
2010-05-12,15,Wednesday,May,2010,False,15,11383
2010-05-13,14,Thursday,May,2010,False,14,11397
2010-05-14,8,Friday,May,2010,False,8,11405
2010-05-15,1,Saturday,May,2010,True,1,11406
2010-05-16,1,Sunday,May,2010,True,1,11407
2010-05-17,13,Monday,May,2010,False,13,11420
2010-05-18,26,Tuesday,May,2010,False,26,11446
2010-05-19,12,Wednesday,May,2010,False,12,11458
2010-05-20,10,Thursday,May,2010,False,10,11468
2010-05-21,4,Friday,May,2010,False,4,11472
2010-05-22,1,Saturday,May,2010,True,1,11473
2010-05-23,0,Sunday,May,2010,True,0,11473
2010-05-24,17,Monday,May,2010,False,17,11490
2010-05-25,23,Tuesday,May,2010,False,23,11513
2010-05-26,17,Wednesday,May,2010,False,17,11530
2010-05-27,10,Thursday,May,2010,False,10,11540
2010-05-28,5,Friday,May,2010,False,5,11545
2010-05-29,0,Saturday,May,2010,True,0,11545
2010-05-30,1,Sunday,May,2010,True,1,11546
2010-05-31,19,Monday,May,2010,False,19,11565
2010-06-01,13,Tuesday,June,2010,False,13,11578
2010-06-02,26,Wednesday,June,2010,False,26,11604
2010-06-03,19,Thursday,June,2010,False,19,11623
2010-06-04,11,Friday,June,2010,False,11,11634
2010-06-05,3,Saturday,June,2010,True,3,11637
2010-06-06,0,Sunday,June,2010,True,0,11637
2010-06-07,7,Monday,June,2010,False,7,11644
2010-06-08,16,Tuesday,June,2010,False,16,11660
2010-06-09,15,Wednesday,June,2010,False,15,11675
2010-06-10,25,Thursday,June,2010,False,25,11700
2010-06-11,10,Friday,June,2010,False,10,11710
2010-06-12,3,Saturday,June,2010,True,3,11713
2010-06-13,3,Sunday,June,2010,True,3,11716
2010-06-14,11,Monday,June,2010,False,11,11727
2010-06-15,11,Tuesday,June,2010,False,11,11738
2010-06-16,16,Wednesday,June,2010,False,16,11754
2010-06-17,10,Thursday,June,2010,False,10,11764
2010-06-18,12,Friday,June,2010,False,12,11776
2010-06-19,1,Saturday,June,2010,True,1,11777
2010-06-20,0,Sunday,June,2010,True,0,11777
2010-06-21,8,Monday,June,2010,False,8,11785
2010-06-22,29,Tuesday,June,2010,False,29,11814
2010-06-23,16,Wednesday,June,2010,False,16,11830
2010-06-24,17,Thursday,June,2010,False,17,11847
2010-06-25,6,Friday,June,2010,False,6,11853
2010-06-26,1,Saturday,June,2010,True,1,11854
2010-06-27,0,Sunday,June,2010,True,0,11854
2010-06-28,18,Monday,June,2010,False,18,11872
2010-06-29,9,Tuesday,June,2010,False,9,11881
2010-06-30,29,Wednesday,June,2010,False,29,11910
2010-07-01,11,Thursday,July,2010,False,11,11921
2010-07-02,5,Friday,July,2010,False,5,11926
2010-07-03,1,Saturday,July,2010,True,1,11927
2010-07-04,4,Sunday,July,2010,True,4,11931
2010-07-05,13,Monday,July,2010,False,13,11944
2010-07-06,25,Tuesday,July,2010,False,25,11969
2010-07-07,15,Wednesday,July,2010,False,15,11984
2010-07-08,44,Thursday,July,2010,False,44,12028
2010-07-09,12,Friday,July,2010,False,12,12040
2010-07-10,2,Saturday,July,2010,True,2,12042
2010-07-11,2,Sunday,July,2010,True,2,12044
2010-07-12,16,Monday,July,2010,False,16,12060
2010-07-13,13,Tuesday,July,2010,False,13,12073
2010-07-14,19,Wednesday,July,2010,False,19,12092
2010-07-15,27,Thursday,July,2010,False,27,12119
2010-07-16,4,Friday,July,2010,False,4,12123
2010-07-17,1,Saturday,July,2010,True,1,12124
2010-07-18,3,Sunday,July,2010,True,3,12127
2010-07-19,12,Monday,July,2010,False,12,12139
2010-07-20,30,Tuesday,July,2010,False,30,12169
2010-07-21,11,Wednesday,July,2010,False,11,12180
2010-07-22,15,Thursday,July,2010,False,15,12195
2010-07-23,8,Friday,July,2010,False,8,12203
2010-07-24,3,Saturday,July,2010,True,3,12206
2010-07-25,3,Sunday,July,2010,True,3,12209
2010-07-26,15,Monday,July,2010,False,15,12224
2010-07-27,22,Tuesday,July,2010,False,22,12246
2010-07-28,17,Wednesday,July,2010,False,17,12263
2010-07-29,5,Thursday,July,2010,False,5,12268
2010-07-30,9,Friday,July,2010,False,9,12277
2010-07-31,,Saturday,July,2010,True,0,12277
2010-08-01,3,Sunday,August,2010,True,3,12280
2010-08-02,10,Monday,August,2010,False,10,12290
2010-08-03,28,Tuesday,August,2010,False,28,12318
2010-08-04,15,Wednesday,August,2010,False,15,12333
2010-08-05,18,Thursday,August,2010,False,18,12351
2010-08-06,9,Friday,August,2010,False,9,12360
2010-08-07,0,Saturday,August,2010,True,0,12360
2010-08-08,3,Sunday,August,2010,True,3,12363
2010-08-09,14,Monday,August,2010,False,14,12377
2010-08-10,21,Tuesday,August,2010,False,21,12398
2010-08-11,14,Wednesday,August,2010,False,14,12412
2010-08-12,15,Thursday,August,2010,False,15,12427
2010-08-13,5,Friday,August,2010,False,5,12432
2010-08-14,2,Saturday,August,2010,True,2,12434
2010-08-15,1,Sunday,August,2010,True,1,12435
2010-08-16,16,Monday,August,2010,False,16,12451
2010-08-17,32,Tuesday,August,2010,False,32,12483
2010-08-18,14,Wednesday,August,2010,False,14,12497
2010-08-19,13,Thursday,August,2010,False,13,12510
2010-08-20,9,Friday,August,2010,False,9,12519
2010-08-21,0,Saturday,August,2010,True,0,12519
2010-08-22,3,Sunday,August,2010,True,3,12522
2010-08-23,11,Monday,August,2010,False,11,12533
2010-08-24,33,Tuesday,August,2010,False,33,12566
2010-08-25,11,Wednesday,August,2010,False,11,12577
2010-08-26,13,Thursday,August,2010,False,13,12590
2010-08-27,11,Friday,August,2010,False,11,12601
2010-08-28,1,Saturday,August,2010,True,1,12602
2010-08-29,3,Sunday,August,2010,True,3,12605
2010-08-30,15,Monday,August,2010,False,15,12620
2010-08-31,27,Tuesday,August,2010,False,27,12647
2010-09-01,12,Wednesday,September,2010,False,12,12659
2010-09-02,22,Thursday,September,2010,False,22,12681
2010-09-03,6,Friday,September,2010,False,6,12687
2010-09-04,3,Saturday,September,2010,True,3,12690
2010-09-05,4,Sunday,September,2010,True,4,12694
2010-09-06,11,Monday,September,2010,False,11,12705
2010-09-07,25,Tuesday,September,2010,False,25,12730
2010-09-08,12,Wednesday,September,2010,False,12,12742
2010-09-09,1,Thursday,September,2010,False,1,12743
2010-09-10,13,Friday,September,2010,False,13,12756
2010-09-11,1,Saturday,September,2010,True,1,12757
2010-09-12,0,Sunday,September,2010,True,0,12757
2010-09-13,19,Monday,September,2010,False,19,12776
2010-09-14,30,Tuesday,September,2010,False,30,12806
2010-09-15,13,Wednesday,September,2010,False,13,12819
2010-09-16,12,Thursday,September,2010,False,12,12831
2010-09-17,15,Friday,September,2010,False,15,12846
2010-09-18,0,Saturday,September,2010,True,0,12846
2010-09-19,0,Sunday,September,2010,True,0,12846
2010-09-20,26,Monday,September,2010,False,26,12872
2010-09-21,17,Tuesday,September,2010,False,17,12889
2010-09-22,11,Wednesday,September,2010,False,11,12900
2010-09-23,11,Thursday,September,2010,False,11,12911
2010-09-24,11,Friday,September,2010,False,11,12922
2010-09-25,2,Saturday,September,2010,True,2,12924
2010-09-26,5,Sunday,September,2010,True,5,12929
2010-09-27,12,Monday,September,2010,False,12,12941
2010-09-28,34,Tuesday,September,2010,False,34,12975
2010-09-29,17,Wednesday,September,2010,False,17,12992
2010-09-30,32,Thursday,September,2010,False,32,13024
2010-10-01,7,Friday,October,2010,False,7,13031
2010-10-02,4,Saturday,October,2010,True,4,13035
2010-10-03,5,Sunday,October,2010,True,5,13040
2010-10-04,30,Monday,October,2010,False,30,13070
2010-10-05,18,Tuesday,October,2010,False,18,13088
2010-10-06,18,Wednesday,October,2010,False,18,13106
2010-10-07,17,Thursday,October,2010,False,17,13123
2010-10-08,21,Friday,October,2010,False,21,13144
2010-10-09,2,Saturday,October,2010,True,2,13146
2010-10-10,4,Sunday,October,2010,True,4,13150
2010-10-11,27,Monday,October,2010,False,27,13177
2010-10-12,23,Tuesday,October,2010,False,23,13200
2010-10-13,8,Wednesday,October,2010,False,8,13208
2010-10-14,14,Thursday,October,2010,False,14,13222
2010-10-15,7,Friday,October,2010,False,7,13229
2010-10-16,1,Saturday,October,2010,True,1,13230
2010-10-17,1,Sunday,October,2010,True,1,13231
2010-10-18,20,Monday,October,2010,False,20,13251
2010-10-19,31,Tuesday,October,2010,False,31,13282
2010-10-20,18,Wednesday,October,2010,False,18,13300
2010-10-21,14,Thursday,October,2010,False,14,13314
2010-10-22,5,Friday,October,2010,False,5,13319
2010-10-23,1,Saturday,October,2010,True,1,13320
2010-10-24,6,Sunday,October,2010,True,6,13326
2010-10-25,25,Monday,October,2010,False,25,13351
2010-10-26,27,Tuesday,October,2010,False,27,13378
2010-10-27,23,Wednesday,October,2010,False,23,13401
2010-10-28,12,Thursday,October,2010,False,12,13413
2010-10-29,8,Friday,October,2010,False,8,13421
2010-10-30,2,Saturday,October,2010,True,2,13423
2010-10-31,1,Sunday,October,2010,True,1,13424
2010-11-01,19,Monday,November,2010,False,19,13443
2010-11-02,17,Tuesday,November,2010,False,17,13460
2010-11-03,13,Wednesday,November,2010,False,13,13473
2010-11-04,14,Thursday,November,2010,False,14,13487
2010-11-05,5,Friday,November,2010,False,5,13492
2010-11-06,4,Saturday,November,2010,True,4,13496
2010-11-07,0,Sunday,November,2010,True,0,13496
2010-11-08,30,Monday,November,2010,False,30,13526
2010-11-09,15,Tuesday,November,2010,False,15,13541
2010-11-10,7,Wednesday,November,2010,False,7,13548
2010-11-11,11,Thursday,November,2010,False,11,13559
2010-11-12,5,Friday,November,2010,False,5,13564
2010-11-13,4,Saturday,November,2010,True,4,13568
2010-11-14,0,Sunday,November,2010,True,0,13568
2010-11-15,18,Monday,November,2010,False,18,13586
2010-11-16,10,Tuesday,November,2010,False,10,13596
2010-11-17,11,Wednesday,November,2010,False,11,13607
2010-11-18,24,Thursday,November,2010,False,24,13631
2010-11-19,6,Friday,November,2010,False,6,13637
2010-11-20,1,Saturday,November,2010,True,1,13638
2010-11-21,3,Sunday,November,2010,True,3,13641
2010-11-22,18,Monday,November,2010,False,18,13659
2010-11-23,9,Tuesday,November,2010,False,9,13668
2010-11-24,16,Wednesday,November,2010,False,16,13684
2010-11-25,20,Thursday,November,2010,False,20,13704
2010-11-26,10,Friday,November,2010,False,10,13714
2010-11-27,3,Saturday,November,2010,True,3,13717
2010-11-28,2,Sunday,November,2010,True,2,13719
2010-11-29,17,Monday,November,2010,False,17,13736
2010-11-30,13,Tuesday,November,2010,False,13,13749
2010-12-01,22,Wednesday,December,2010,False,22,13771
2010-12-02,11,Thursday,December,2010,False,11,13782
2010-12-03,6,Friday,December,2010,False,6,13788
2010-12-04,0,Saturday,December,2010,True,0,13788
2010-12-05,0,Sunday,December,2010,True,0,13788
2010-12-06,26,Monday,December,2010,False,26,13814
2010-12-07,25,Tuesday,December,2010,False,25,13839
2010-12-08,15,Wednesday,December,2010,False,15,13854
2010-12-09,12,Thursday,December,2010,False,12,13866
2010-12-10,5,Friday,December,2010,False,5,13871
2010-12-11,0,Saturday,December,2010,True,0,13871
2010-12-12,2,Sunday,December,2010,True,2,13873
2010-12-13,12,Monday,December,2010,False,12,13885
2010-12-14,20,Tuesday,December,2010,False,20,13905
2010-12-15,16,Wednesday,December,2010,False,16,13921
2010-12-16,13,Thursday,December,2010,False,13,13934
2010-12-17,7,Friday,December,2010,False,7,13941
2010-12-18,5,Saturday,December,2010,True,5,13946
2010-12-19,0,Sunday,December,2010,True,0,13946
2010-12-20,15,Monday,December,2010,False,15,13961
2010-12-21,7,Tuesday,December,2010,False,7,13968
2010-12-22,12,Wednesday,December,2010,False,12,13980
2010-12-23,4,Thursday,December,2010,False,4,13984
2010-12-24,7,Friday,December,2010,False,7,13991
2010-12-25,0,Saturday,December,2010,True,0,13991
2010-12-26,0,Sunday,December,2010,True,0,13991
2010-12-27,2,Monday,December,2010,False,2,13993
2010-12-28,0,Tuesday,December,2010,False,0,13993
2010-12-29,4,Wednesday,December,2010,False,4,13997
2010-12-30,1,Thursday,December,2010,False,1,13998
2010-12-31,3,Friday,December,2010,False,3,14001
2011-01-01,4,Saturday,January,2011,True,4,14005
2011-01-02,1,Sunday,January,2011,True,1,14006
2011-01-03,4,Monday,January,2011,False,4,14010
2011-01-04,7,Tuesday,January,2011,False,7,14017
2011-01-05,12,Wednesday,January,2011,False,12,14029
2011-01-06,17,Thursday,January,2011,False,17,14046
2011-01-07,9,Friday,January,2011,False,9,14055
2011-01-08,2,Saturday,January,2011,True,2,14057
2011-01-09,4,Sunday,January,2011,True,4,14061
2011-01-10,19,Monday,January,2011,False,19,14080
2011-01-11,25,Tuesday,January,2011,False,25,14105
2011-01-12,18,Wednesday,January,2011,False,18,14123
2011-01-13,13,Thursday,January,2011,False,13,14136
2011-01-14,7,Friday,January,2011,False,7,14143
2011-01-15,4,Saturday,January,2011,True,4,14147
2011-01-16,1,Sunday,January,2011,True,1,14148
2011-01-17,16,Monday,January,2011,False,16,14164
2011-01-18,7,Tuesday,January,2011,False,7,14171
2011-01-19,27,Wednesday,January,2011,False,27,14198
2011-01-20,32,Thursday,January,2011,False,32,14230
2011-01-21,7,Friday,January,2011,False,7,14237
2011-01-22,,Saturday,January,2011,True,0,14237
2011-01-23,2,Sunday,January,2011,True,2,14239
2011-01-24,25,Monday,January,2011,False,25,14264
2011-01-25,21,Tuesday,January,2011,False,21,14285
2011-01-26,25,Wednesday,January,2011,False,25,14310
2011-01-27,5,Thursday,January,2011,False,5,14315
2011-01-28,3,Friday,January,2011,False,3,14318
2011-01-29,1,Saturday,January,2011,True,1,14319
2011-01-30,0,Sunday,January,2011,True,0,14319
2011-01-31,18,Monday,January,2011,False,18,14337
2011-02-01,20,Tuesday,February,2011,False,20,14357
2011-02-02,28,Wednesday,February,2011,False,28,14385
2011-02-03,25,Thursday,February,2011,False,25,14410
2011-02-04,8,Friday,February,2011,False,8,14418
2011-02-05,3,Saturday,February,2011,True,3,14421
2011-02-06,1,Sunday,February,2011,True,1,14422
2011-02-07,16,Monday,February,2011,False,16,14438
2011-02-08,22,Tuesday,February,2011,False,22,14460
2011-02-09,24,Wednesday,February,2011,False,24,14484
2011-02-10,15,Thursday,February,2011,False,15,14499
2011-02-11,4,Friday,February,2011,False,4,14503
2011-02-12,1,Saturday,February,2011,True,1,14504
2011-02-13,0,Sunday,February,2011,True,0,14504
2011-02-14,13,Monday,February,2011,False,13,14517
2011-02-15,7,Tuesday,February,2011,False,7,14524
2011-02-16,8,Wednesday,February,2011,False,8,14532
2011-02-17,12,Thursday,February,2011,False,12,14544
2011-02-18,7,Friday,February,2011,False,7,14551
2011-02-19,1,Saturday,February,2011,True,1,14552
2011-02-20,2,Sunday,February,2011,True,2,14554
2011-02-21,8,Monday,February,2011,False,8,14562
2011-02-22,7,Tuesday,February,2011,False,7,14569
2011-02-23,2,Wednesday,February,2011,False,2,14571
2011-02-24,8,Thursday,February,2011,False,8,14579
2011-02-25,7,Friday,February,2011,False,7,14586
2011-02-26,0,Saturday,February,2011,True,0,14586
2011-02-27,1,Sunday,February,2011,True,1,14587
2011-02-28,22,Monday,February,2011,False,22,14609
2011-03-01,4,Tuesday,March,2011,False,4,14613
2011-03-02,23,Wednesday,March,2011,False,23,14636
2011-03-03,8,Thursday,March,2011,False,8,14644
2011-03-04,5,Friday,March,2011,False,5,14649
2011-03-05,1,Saturday,March,2011,True,1,14650
2011-03-06,0,Sunday,March,2011,True,0,14650
2011-03-07,12,Monday,March,2011,False,12,14662
2011-03-08,9,Tuesday,March,2011,False,9,14671
2011-03-09,8,Wednesday,March,2011,False,8,14679
2011-03-10,7,Thursday,March,2011,False,7,14686
2011-03-11,14,Friday,March,2011,False,14,14700
2011-03-12,1,Saturday,March,2011,True,1,14701
2011-03-13,2,Sunday,March,2011,True,2,14703
2011-03-14,12,Monday,March,2011,False,12,14715
2011-03-15,11,Tuesday,March,2011,False,11,14726
2011-03-16,14,Wednesday,March,2011,False,14,14740
2011-03-17,5,Thursday,March,2011,False,5,14745
2011-03-18,5,Friday,March,2011,False,5,14750
2011-03-19,1,Saturday,March,2011,True,1,14751
2011-03-20,2,Sunday,March,2011,True,2,14753
2011-03-21,19,Monday,March,2011,False,19,14772
2011-03-22,19,Tuesday,March,2011,False,19,14791
2011-03-23,14,Wednesday,March,2011,False,14,14805
2011-03-24,14,Thursday,March,2011,False,14,14819
2011-03-25,7,Friday,March,2011,False,7,14826
2011-03-26,0,Saturday,March,2011,True,0,14826
2011-03-27,3,Sunday,March,2011,True,3,14829
2011-03-28,6,Monday,March,2011,False,6,14835
2011-03-29,8,Tuesday,March,2011,False,8,14843
2011-03-30,7,Wednesday,March,2011,False,7,14850
2011-03-31,15,Thursday,March,2011,False,15,14865
2011-04-01,3,Friday,April,2011,False,3,14868
2011-04-02,0,Saturday,April,2011,True,0,14868
2011-04-03,0,Sunday,April,2011,True,0,14868
2011-04-04,14,Monday,April,2011,False,14,14882
2011-04-05,9,Tuesday,April,2011,False,9,14891
2011-04-06,13,Wednesday,April,2011,False,13,14904
2011-04-07,14,Thursday,April,2011,False,14,14918
2011-04-08,10,Friday,April,2011,False,10,14928
2011-04-09,0,Saturday,April,2011,True,0,14928
2011-04-10,3,Sunday,April,2011,True,3,14931
2011-04-11,11,Monday,April,2011,False,11,14942
2011-04-12,9,Tuesday,April,2011,False,9,14951
2011-04-13,4,Wednesday,April,2011,False,4,14955
2011-04-14,9,Thursday,April,2011,False,9,14964
2011-04-15,5,Friday,April,2011,False,5,14969
2011-04-16,0,Saturday,April,2011,True,0,14969
2011-04-17,3,Sunday,April,2011,True,3,14972
2011-04-18,12,Monday,April,2011,False,12,14984
2011-04-19,11,Tuesday,April,2011,False,11,14995
2011-04-20,10,Wednesday,April,2011,False,10,15005
2011-04-21,12,Thursday,April,2011,False,12,15017
2011-04-22,3,Friday,April,2011,False,3,15020
2011-04-23,1,Saturday,April,2011,True,1,15021
2011-04-24,0,Sunday,April,2011,True,0,15021
2011-04-25,4,Monday,April,2011,False,4,15025
2011-04-26,0,Tuesday,April,2011,False,0,15025
2011-04-27,9,Wednesday,April,2011,False,9,15034
2011-04-28,10,Thursday,April,2011,False,10,15044
2011-04-29,11,Friday,April,2011,False,11,15055
2011-04-30,0,Saturday,April,2011,True,0,15055
2011-05-01,0,Sunday,May,2011,True,0,15055
2011-05-02,13,Monday,May,2011,False,13,15068
2011-05-03,26,Tuesday,May,2011,False,26,15094
2011-05-04,12,Wednesday,May,2011,False,12,15106
2011-05-05,10,Thursday,May,2011,False,10,15116
2011-05-06,12,Friday,May,2011,False,12,15128
2011-05-07,2,Saturday,May,2011,True,2,15130
2011-05-08,3,Sunday,May,2011,True,3,15133
2011-05-09,10,Monday,May,2011,False,10,15143
2011-05-10,12,Tuesday,May,2011,False,12,15155
2011-05-11,16,Wednesday,May,2011,False,16,15171
2011-05-12,10,Thursday,May,2011,False,10,15181
2011-05-13,5,Friday,May,2011,False,5,15186
2011-05-14,1,Saturday,May,2011,True,1,15187
2011-05-15,2,Sunday,May,2011,True,2,15189
2011-05-16,16,Monday,May,2011,False,16,15205
2011-05-17,10,Tuesday,May,2011,False,10,15215
2011-05-18,16,Wednesday,May,2011,False,16,15231
2011-05-19,13,Thursday,May,2011,False,13,15244
2011-05-20,8,Friday,May,2011,False,8,15252
2011-05-21,2,Saturday,May,2011,True,2,15254
2011-05-22,2,Sunday,May,2011,True,2,15256
2011-05-23,15,Monday,May,2011,False,15,15271
2011-05-24,17,Tuesday,May,2011,False,17,15288
2011-05-25,2,Wednesday,May,2011,False,2,15290
2011-05-26,8,Thursday,May,2011,False,8,15298
2011-05-27,3,Friday,May,2011,False,3,15301
2011-05-28,0,Saturday,May,2011,True,0,15301
2011-05-29,1,Sunday,May,2011,True,1,15302
2011-05-30,13,Monday,May,2011,False,13,15315
2011-05-31,12,Tuesday,May,2011,False,12,15327
2011-06-01,11,Wednesday,June,2011,False,11,15338
2011-06-02,13,Thursday,June,2011,False,13,15351
2011-06-03,6,Friday,June,2011,False,6,15357
2011-06-04,4,Saturday,June,2011,True,4,15361
2011-06-05,2,Sunday,June,2011,True,2,15363
2011-06-06,22,Monday,June,2011,False,22,15385
2011-06-07,34,Tuesday,June,2011,False,34,15419
2011-06-08,15,Wednesday,June,2011,False,15,15434
2011-06-09,27,Thursday,June,2011,False,27,15461
2011-06-10,3,Friday,June,2011,False,3,15464
2011-06-11,3,Saturday,June,2011,True,3,15467
2011-06-12,1,Sunday,June,2011,True,1,15468
2011-06-13,18,Monday,June,2011,False,18,15486
2011-06-14,19,Tuesday,June,2011,False,19,15505
2011-06-15,8,Wednesday,June,2011,False,8,15513
2011-06-16,16,Thursday,June,2011,False,16,15529
2011-06-17,4,Friday,June,2011,False,4,15533
2011-06-18,0,Saturday,June,2011,True,0,15533
2011-06-19,0,Sunday,June,2011,True,0,15533
2011-06-20,15,Monday,June,2011,False,15,15548
2011-06-21,19,Tuesday,June,2011,False,19,15567
2011-06-22,19,Wednesday,June,2011,False,19,15586
2011-06-23,17,Thursday,June,2011,False,17,15603
2011-06-24,4,Friday,June,2011,False,4,15607
2011-06-25,4,Saturday,June,2011,True,4,15611
2011-06-26,4,Sunday,June,2011,True,4,15615
2011-06-27,17,Monday,June,2011,False,17,15632
2011-06-28,21,Tuesday,June,2011,False,21,15653
2011-06-29,17,Wednesday,June,2011,False,17,15670
2011-06-30,13,Thursday,June,2011,False,13,15683
2011-07-01,15,Friday,July,2011,False,15,15698
2011-07-02,1,Saturday,July,2011,True,1,15699
2011-07-03,1,Sunday,July,2011,True,1,15700
2011-07-04,24,Monday,July,2011,False,24,15724
2011-07-05,20,Tuesday,July,2011,False,20,15744
2011-07-06,22,Wednesday,July,2011,False,22,15766
2011-07-07,15,Thursday,July,2011,False,15,15781
2011-07-08,13,Friday,July,2011,False,13,15794
2011-07-09,1,Saturday,July,2011,True,1,15795
2011-07-10,2,Sunday,July,2011,True,2,15797
2011-07-11,23,Monday,July,2011,False,23,15820
2011-07-12,21,Tuesday,July,2011,False,21,15841
2011-07-13,12,Wednesday,July,2011,False,12,15853
2011-07-14,14,Thursday,July,2011,False,14,15867
2011-07-15,6,Friday,July,2011,False,6,15873
2011-07-16,3,Saturday,July,2011,True,3,15876
2011-07-17,0,Sunday,July,2011,True,0,15876
2011-07-18,15,Monday,July,2011,False,15,15891
2011-07-19,27,Tuesday,July,2011,False,27,15918
2011-07-20,17,Wednesday,July,2011,False,17,15935
2011-07-21,12,Thursday,July,2011,False,12,15947
2011-07-22,5,Friday,July,2011,False,5,15952
2011-07-23,3,Saturday,July,2011,True,3,15955
2011-07-24,2,Sunday,July,2011,True,2,15957
2011-07-25,13,Monday,July,2011,False,13,15970
2011-07-26,9,Tuesday,July,2011,False,9,15979
2011-07-27,13,Wednesday,July,2011,False,13,15992
2011-07-28,24,Thursday,July,2011,False,24,16016
2011-07-29,4,Friday,July,2011,False,4,16020
2011-07-30,3,Saturday,July,2011,True,3,16023
2011-07-31,2,Sunday,July,2011,True,2,16025
2011-08-01,16,Monday,August,2011,False,16,16041
2011-08-02,19,Tuesday,August,2011,False,19,16060
2011-08-03,26,Wednesday,August,2011,False,26,16086
2011-08-04,8,Thursday,August,2011,False,8,16094
2011-08-05,9,Friday,August,2011,False,9,16103
2011-08-06,2,Saturday,August,2011,True,2,16105
2011-08-07,0,Sunday,August,2011,True,0,16105
2011-08-08,14,Monday,August,2011,False,14,16119
2011-08-09,19,Tuesday,August,2011,False,19,16138
2011-08-10,6,Wednesday,August,2011,False,6,16144
2011-08-11,7,Thursday,August,2011,False,7,16151
2011-08-12,7,Friday,August,2011,False,7,16158
2011-08-13,2,Saturday,August,2011,True,2,16160
2011-08-14,2,Sunday,August,2011,True,2,16162
2011-08-15,11,Monday,August,2011,False,11,16173
2011-08-16,23,Tuesday,August,2011,False,23,16196
2011-08-17,15,Wednesday,August,2011,False,15,16211
2011-08-18,10,Thursday,August,2011,False,10,16221
2011-08-19,6,Friday,August,2011,False,6,16227
2011-08-20,0,Saturday,August,2011,True,0,16227
2011-08-21,1,Sunday,August,2011,True,1,16228
2011-08-22,9,Monday,August,2011,False,9,16237
2011-08-23,18,Tuesday,August,2011,False,18,16255
2011-08-24,15,Wednesday,August,2011,False,15,16270
2011-08-25,14,Thursday,August,2011,False,14,16284
2011-08-26,8,Friday,August,2011,False,8,16292
2011-08-27,0,Saturday,August,2011,True,0,16292
2011-08-28,1,Sunday,August,2011,True,1,16293
2011-08-29,18,Monday,August,2011,False,18,16311
2011-08-30,8,Tuesday,August,2011,False,8,16319
2011-08-31,5,Wednesday,August,2011,False,5,16324
2011-09-01,31,Thursday,September,2011,False,31,16355
2011-09-02,11,Friday,September,2011,False,11,16366
2011-09-03,2,Saturday,September,2011,True,2,16368
2011-09-04,2,Sunday,September,2011,True,2,16370
2011-09-05,8,Monday,September,2011,False,8,16378
2011-09-06,20,Tuesday,September,2011,False,20,16398
2011-09-07,16,Wednesday,September,2011,False,16,16414
2011-09-08,24,Thursday,September,2011,False,24,16438
2011-09-09,5,Friday,September,2011,False,5,16443
2011-09-10,1,Saturday,September,2011,True,1,16444
2011-09-11,1,Sunday,September,2011,True,1,16445
2011-09-12,16,Monday,September,2011,False,16,16461
2011-09-13,6,Tuesday,September,2011,False,6,16467
2011-09-14,4,Wednesday,September,2011,False,4,16471
2011-09-15,5,Thursday,September,2011,False,5,16476
2011-09-16,4,Friday,September,2011,False,4,16480
2011-09-17,1,Saturday,September,2011,True,1,16481
2011-09-18,1,Sunday,September,2011,True,1,16482
2011-09-19,5,Monday,September,2011,False,5,16487
2011-09-20,14,Tuesday,September,2011,False,14,16501
2011-09-21,10,Wednesday,September,2011,False,10,16511
2011-09-22,8,Thursday,September,2011,False,8,16519
2011-09-23,4,Friday,September,2011,False,4,16523
2011-09-24,1,Saturday,September,2011,True,1,16524
2011-09-25,1,Sunday,September,2011,True,1,16525
2011-09-26,20,Monday,September,2011,False,20,16545
2011-09-27,6,Tuesday,September,2011,False,6,16551
2011-09-28,9,Wednesday,September,2011,False,9,16560
2011-09-29,6,Thursday,September,2011,False,6,16566
2011-09-30,9,Friday,September,2011,False,9,16575
2011-10-01,1,Saturday,October,2011,True,1,16576
2011-10-02,1,Sunday,October,2011,True,1,16577
2011-10-03,4,Monday,October,2011,False,4,16581
2011-10-04,6,Tuesday,October,2011,False,6,16587
2011-10-05,14,Wednesday,October,2011,False,14,16601
2011-10-06,16,Thursday,October,2011,False,16,16617
2011-10-07,4,Friday,October,2011,False,4,16621
2011-10-08,1,Saturday,October,2011,True,1,16622
2011-10-09,3,Sunday,October,2011,True,3,16625
2011-10-10,21,Monday,October,2011,False,21,16646
2011-10-11,15,Tuesday,October,2011,False,15,16661
2011-10-12,15,Wednesday,October,2011,False,15,16676
2011-10-13,19,Thursday,October,2011,False,19,16695
2011-10-14,2,Friday,October,2011,False,2,16697
2011-10-15,0,Saturday,October,2011,True,0,16697
2011-10-16,0,Sunday,October,2011,True,0,16697
2011-10-17,26,Monday,October,2011,False,26,16723
2011-10-18,14,Tuesday,October,2011,False,14,16737
2011-10-19,26,Wednesday,October,2011,False,26,16763
2011-10-20,16,Thursday,October,2011,False,16,16779
2011-10-21,6,Friday,October,2011,False,6,16785
2011-10-22,7,Saturday,October,2011,True,7,16792
2011-10-23,0,Sunday,October,2011,True,0,16792
2011-10-24,24,Monday,October,2011,False,24,16816
2011-10-25,15,Tuesday,October,2011,False,15,16831
2011-10-26,15,Wednesday,October,2011,False,15,16846
2011-10-27,7,Thursday,October,2011,False,7,16853
2011-10-28,11,Friday,October,2011,False,11,16864
2011-10-29,1,Saturday,October,2011,True,1,16865
2011-10-30,1,Sunday,October,2011,True,1,16866
2011-10-31,21,Monday,October,2011,False,21,16887
2011-11-01,16,Tuesday,November,2011,False,16,16903
2011-11-02,30,Wednesday,November,2011,False,30,16933
2011-11-03,13,Thursday,November,2011,False,13,16946
2011-11-04,14,Friday,November,2011,False,14,16960
2011-11-05,0,Saturday,November,2011,True,0,16960
2011-11-06,1,Sunday,November,2011,True,1,16961
2011-11-07,7,Monday,November,2011,False,7,16968
2011-11-08,6,Tuesday,November,2011,False,6,16974
2011-11-09,21,Wednesday,November,2011,False,21,16995
2011-11-10,18,Thursday,November,2011,False,18,17013
2011-11-11,3,Friday,November,2011,False,3,17016
2011-11-12,2,Saturday,November,2011,True,2,17018
2011-11-13,0,Sunday,November,2011,True,0,17018
2011-11-14,13,Monday,November,2011,False,13,17031
2011-11-15,12,Tuesday,November,2011,False,12,17043
2011-11-16,18,Wednesday,November,2011,False,18,17061
2011-11-17,16,Thursday,November,2011,False,16,17077
2011-11-18,11,Friday,November,2011,False,11,17088
2011-11-19,0,Saturday,November,2011,True,0,17088
2011-11-20,1,Sunday,November,2011,True,1,17089
2011-11-21,14,Monday,November,2011,False,14,17103
2011-11-22,24,Tuesday,November,2011,False,24,17127
2011-11-23,15,Wednesday,November,2011,False,15,17142
2011-11-24,13,Thursday,November,2011,False,13,17155
2011-11-25,9,Friday,November,2011,False,9,17164
2011-11-26,1,Saturday,November,2011,True,1,17165
2011-11-27,0,Sunday,November,2011,True,0,17165
2011-11-28,14,Monday,November,2011,False,14,17179
2011-11-29,23,Tuesday,November,2011,False,23,17202
2011-11-30,15,Wednesday,November,2011,False,15,17217
2011-12-01,17,Thursday,December,2011,False,17,17234
2011-12-02,7,Friday,December,2011,False,7,17241
2011-12-03,0,Saturday,December,2011,True,0,17241
2011-12-04,0,Sunday,December,2011,True,0,17241
2011-12-05,18,Monday,December,2011,False,18,17259
2011-12-06,24,Tuesday,December,2011,False,24,17283
2011-12-07,14,Wednesday,December,2011,False,14,17297
2011-12-08,10,Thursday,December,2011,False,10,17307
2011-12-09,6,Friday,December,2011,False,6,17313
2011-12-10,3,Saturday,December,2011,True,3,17316
2011-12-11,1,Sunday,December,2011,True,1,17317
2011-12-12,19,Monday,December,2011,False,19,17336
2011-12-13,18,Tuesday,December,2011,False,18,17354
2011-12-14,16,Wednesday,December,2011,False,16,17370
2011-12-15,24,Thursday,December,2011,False,24,17394
2011-12-16,16,Friday,December,2011,False,16,17410
2011-12-17,0,Saturday,December,2011,True,0,17410
2011-12-18,1,Sunday,December,2011,True,1,17411
2011-12-19,23,Monday,December,2011,False,23,17434
2011-12-20,20,Tuesday,December,2011,False,20,17454
2011-12-21,17,Wednesday,December,2011,False,17,17471
2011-12-22,17,Thursday,December,2011,False,17,17488
2011-12-23,11,Friday,December,2011,False,11,17499
2011-12-24,0,Saturday,December,2011,True,0,17499
2011-12-25,0,Sunday,December,2011,True,0,17499
2011-12-26,2,Monday,December,2011,False,2,17501
2011-12-27,2,Tuesday,December,2011,False,2,17503
2011-12-28,5,Wednesday,December,2011,False,5,17508
2011-12-29,6,Thursday,December,2011,False,6,17514
2011-12-30,5,Friday,December,2011,False,5,17519
2011-12-31,,Saturday,December,2011,True,0,17519
2012-01-01,15,Sunday,January,2012,True,15,17534
2012-01-02,1,Monday,January,2012,False,1,17535
2012-01-03,8,Tuesday,January,2012,False,8,17543
2012-01-04,8,Wednesday,January,2012,False,8,17551
2012-01-05,10,Thursday,January,2012,False,10,17561
2012-01-06,14,Friday,January,2012,False,14,17575
2012-01-07,2,Saturday,January,2012,True,2,17577
2012-01-08,0,Sunday,January,2012,True,0,17577
2012-01-09,22,Monday,January,2012,False,22,17599
2012-01-10,12,Tuesday,January,2012,False,12,17611
2012-01-11,13,Wednesday,January,2012,False,13,17624
2012-01-12,9,Thursday,January,2012,False,9,17633
2012-01-13,14,Friday,January,2012,False,14,17647
2012-01-14,2,Saturday,January,2012,True,2,17649
2012-01-15,2,Sunday,January,2012,True,2,17651
2012-01-16,20,Monday,January,2012,False,20,17671
2012-01-17,16,Tuesday,January,2012,False,16,17687
2012-01-18,15,Wednesday,January,2012,False,15,17702
2012-01-19,19,Thursday,January,2012,False,19,17721
2012-01-20,8,Friday,January,2012,False,8,17729
2012-01-21,2,Saturday,January,2012,True,2,17731
2012-01-22,,Sunday,January,2012,True,0,17731
2012-01-23,16,Monday,January,2012,False,16,17747
2012-01-24,30,Tuesday,January,2012,False,30,17777
2012-01-25,15,Wednesday,January,2012,False,15,17792
2012-01-26,19,Thursday,January,2012,False,19,17811
2012-01-27,12,Friday,January,2012,False,12,17823
2012-01-28,1,Saturday,January,2012,True,1,17824
2012-01-29,1,Sunday,January,2012,True,1,17825
2012-01-30,23,Monday,January,2012,False,23,17848
2012-01-31,20,Tuesday,January,2012,False,20,17868
2012-02-01,15,Wednesday,February,2012,False,15,17883
2012-02-02,29,Thursday,February,2012,False,29,17912
2012-02-03,6,Friday,February,2012,False,6,17918
2012-02-04,2,Saturday,February,2012,True,2,17920
2012-02-05,1,Sunday,February,2012,True,1,17921
2012-02-06,13,Monday,February,2012,False,13,17934
2012-02-07,14,Tuesday,February,2012,False,14,17948
2012-02-08,9,Wednesday,February,2012,False,9,17957
2012-02-09,12,Thursday,February,2012,False,12,17969
2012-02-10,7,Friday,February,2012,False,7,17976
2012-02-11,1,Saturday,February,2012,True,1,17977
2012-02-12,0,Sunday,February,2012,True,0,17977
2012-02-13,22,Monday,February,2012,False,22,17999
2012-02-14,13,Tuesday,February,2012,False,13,18012
2012-02-15,17,Wednesday,February,2012,False,17,18029
2012-02-16,23,Thursday,February,2012,False,23,18052
2012-02-17,15,Friday,February,2012,False,15,18067
2012-02-18,5,Saturday,February,2012,True,5,18072
2012-02-19,1,Sunday,February,2012,True,1,18073
2012-02-20,19,Monday,February,2012,False,19,18092
2012-02-21,24,Tuesday,February,2012,False,24,18116
2012-02-22,19,Wednesday,February,2012,False,19,18135
2012-02-23,17,Thursday,February,2012,False,17,18152
2012-02-24,8,Friday,February,2012,False,8,18160
2012-02-25,2,Saturday,February,2012,True,2,18162
2012-02-26,0,Sunday,February,2012,True,0,18162
2012-02-27,20,Monday,February,2012,False,20,18182
2012-02-28,13,Tuesday,February,2012,False,13,18195
2012-02-29,24,Wednesday,February,2012,False,24,18219
2012-03-01,9,Thursday,March,2012,False,9,18228
2012-03-02,7,Friday,March,2012,False,7,18235
2012-03-03,1,Saturday,March,2012,True,1,18236
2012-03-04,2,Sunday,March,2012,True,2,18238
2012-03-05,16,Monday,March,2012,False,16,18254
2012-03-06,22,Tuesday,March,2012,False,22,18276
2012-03-07,16,Wednesday,March,2012,False,16,18292
2012-03-08,25,Thursday,March,2012,False,25,18317
2012-03-09,3,Friday,March,2012,False,3,18320
2012-03-10,1,Saturday,March,2012,True,1,18321
2012-03-11,1,Sunday,March,2012,True,1,18322
2012-03-12,23,Monday,March,2012,False,23,18345
2012-03-13,15,Tuesday,March,2012,False,15,18360
2012-03-14,11,Wednesday,March,2012,False,11,18371
2012-03-15,22,Thursday,March,2012,False,22,18393
2012-03-16,5,Friday,March,2012,False,5,18398
2012-03-17,1,Saturday,March,2012,True,1,18399
2012-03-18,1,Sunday,March,2012,True,1,18400
2012-03-19,14,Monday,March,2012,False,14,18414
2012-03-20,17,Tuesday,March,2012,False,17,18431
2012-03-21,27,Wednesday,March,2012,False,27,18458
2012-03-22,12,Thursday,March,2012,False,12,18470
2012-03-23,19,Friday,March,2012,False,19,18489
2012-03-24,2,Saturday,March,2012,True,2,18491
2012-03-25,1,Sunday,March,2012,True,1,18492
2012-03-26,6,Monday,March,2012,False,6,18498
2012-03-27,26,Tuesday,March,2012,False,26,18524
2012-03-28,12,Wednesday,March,2012,False,12,18536
2012-03-29,13,Thursday,March,2012,False,13,18549
2012-03-30,3,Friday,March,2012,False,3,18552
2012-03-31,3,Saturday,March,2012,True,3,18555
2012-04-01,2,Sunday,April,2012,True,2,18557
2012-04-02,20,Monday,April,2012,False,20,18577
2012-04-03,23,Tuesday,April,2012,False,23,18600
2012-04-04,9,Wednesday,April,2012,False,9,18609
2012-04-05,10,Thursday,April,2012,False,10,18619
2012-04-06,1,Friday,April,2012,False,1,18620
2012-04-07,2,Saturday,April,2012,True,2,18622
2012-04-08,0,Sunday,April,2012,True,0,18622
2012-04-09,2,Monday,April,2012,False,2,18624
2012-04-10,9,Tuesday,April,2012,False,9,18633
2012-04-11,18,Wednesday,April,2012,False,18,18651
2012-04-12,14,Thursday,April,2012,False,14,18665
2012-04-13,6,Friday,April,2012,False,6,18671
2012-04-14,2,Saturday,April,2012,True,2,18673
2012-04-15,1,Sunday,April,2012,True,1,18674
2012-04-16,12,Monday,April,2012,False,12,18686
2012-04-17,12,Tuesday,April,2012,False,12,18698
2012-04-18,16,Wednesday,April,2012,False,16,18714
2012-04-19,18,Thursday,April,2012,False,18,18732
2012-04-20,12,Friday,April,2012,False,12,18744
2012-04-21,0,Saturday,April,2012,True,0,18744
2012-04-22,2,Sunday,April,2012,True,2,18746
2012-04-23,23,Monday,April,2012,False,23,18769
2012-04-24,22,Tuesday,April,2012,False,22,18791
2012-04-25,14,Wednesday,April,2012,False,14,18805
2012-04-26,11,Thursday,April,2012,False,11,18816
2012-04-27,10,Friday,April,2012,False,10,18826
2012-04-28,0,Saturday,April,2012,True,0,18826
2012-04-29,2,Sunday,April,2012,True,2,18828
2012-04-30,17,Monday,April,2012,False,17,18845
2012-05-01,5,Tuesday,May,2012,False,5,18850
2012-05-02,21,Wednesday,May,2012,False,21,18871
2012-05-03,25,Thursday,May,2012,False,25,18896
2012-05-04,9,Friday,May,2012,False,9,18905
2012-05-05,2,Saturday,May,2012,True,2,18907
2012-05-06,1,Sunday,May,2012,True,1,18908
2012-05-07,18,Monday,May,2012,False,18,18926
2012-05-08,25,Tuesday,May,2012,False,25,18951
2012-05-09,25,Wednesday,May,2012,False,25,18976
2012-05-10,12,Thursday,May,2012,False,12,18988
2012-05-11,10,Friday,May,2012,False,10,18998
2012-05-12,2,Saturday,May,2012,True,2,19000
2012-05-13,0,Sunday,May,2012,True,0,19000
2012-05-14,14,Monday,May,2012,False,14,19014
2012-05-15,19,Tuesday,May,2012,False,19,19033
2012-05-16,14,Wednesday,May,2012,False,14,19047
2012-05-17,19,Thursday,May,2012,False,19,19066
2012-05-18,5,Friday,May,2012,False,5,19071
2012-05-19,2,Saturday,May,2012,True,2,19073
2012-05-20,5,Sunday,May,2012,True,5,19078
2012-05-21,19,Monday,May,2012,False,19,19097
2012-05-22,22,Tuesday,May,2012,False,22,19119
2012-05-23,13,Wednesday,May,2012,False,13,19132
2012-05-24,15,Thursday,May,2012,False,15,19147
2012-05-25,4,Friday,May,2012,False,4,19151
2012-05-26,1,Saturday,May,2012,True,1,19152
2012-05-27,3,Sunday,May,2012,True,3,19155
2012-05-28,29,Monday,May,2012,False,29,19184
2012-05-29,6,Tuesday,May,2012,False,6,19190
2012-05-30,19,Wednesday,May,2012,False,19,19209
2012-05-31,18,Thursday,May,2012,False,18,19227
2012-06-01,5,Friday,June,2012,False,5,19232
2012-06-02,1,Saturday,June,2012,True,1,19233
2012-06-03,0,Sunday,June,2012,True,0,19233
2012-06-04,12,Monday,June,2012,False,12,19245
2012-06-05,14,Tuesday,June,2012,False,14,19259
2012-06-06,16,Wednesday,June,2012,False,16,19275
2012-06-07,17,Thursday,June,2012,False,17,19292
2012-06-08,11,Friday,June,2012,False,11,19303
2012-06-09,5,Saturday,June,2012,True,5,19308
2012-06-10,4,Sunday,June,2012,True,4,19312
2012-06-11,25,Monday,June,2012,False,25,19337
2012-06-12,26,Tuesday,June,2012,False,26,19363
2012-06-13,10,Wednesday,June,2012,False,10,19373
2012-06-14,13,Thursday,June,2012,False,13,19386
2012-06-15,6,Friday,June,2012,False,6,19392
2012-06-16,1,Saturday,June,2012,True,1,19393
2012-06-17,3,Sunday,June,2012,True,3,19396
2012-06-18,19,Monday,June,2012,False,19,19415
2012-06-19,9,Tuesday,June,2012,False,9,19424
2012-06-20,17,Wednesday,June,2012,False,17,19441
2012-06-21,11,Thursday,June,2012,False,11,19452
2012-06-22,5,Friday,June,2012,False,5,19457
2012-06-23,1,Saturday,June,2012,True,1,19458
2012-06-24,2,Sunday,June,2012,True,2,19460
2012-06-25,20,Monday,June,2012,False,20,19480
2012-06-26,23,Tuesday,June,2012,False,23,19503
2012-06-27,16,Wednesday,June,2012,False,16,19519
2012-06-28,13,Thursday,June,2012,False,13,19532
2012-06-29,6,Friday,June,2012,False,6,19538
2012-06-30,1,Saturday,June,2012,True,1,19539
2012-07-01,1,Sunday,July,2012,True,1,19540
2012-07-02,13,Monday,July,2012,False,13,19553
2012-07-03,15,Tuesday,July,2012,False,15,19568
2012-07-04,9,Wednesday,July,2012,False,9,19577
2012-07-05,17,Thursday,July,2012,False,17,19594
2012-07-06,6,Friday,July,2012,False,6,19600
2012-07-07,3,Saturday,July,2012,True,3,19603
2012-07-08,4,Sunday,July,2012,True,4,19607
2012-07-09,16,Monday,July,2012,False,16,19623
2012-07-10,21,Tuesday,July,2012,False,21,19644
2012-07-11,11,Wednesday,July,2012,False,11,19655
2012-07-12,22,Thursday,July,2012,False,22,19677
2012-07-13,7,Friday,July,2012,False,7,19684
2012-07-14,5,Saturday,July,2012,True,5,19689
2012-07-15,2,Sunday,July,2012,True,2,19691
2012-07-16,24,Monday,July,2012,False,24,19715
2012-07-17,12,Tuesday,July,2012,False,12,19727
2012-07-18,17,Wednesday,July,2012,False,17,19744
2012-07-19,15,Thursday,July,2012,False,15,19759
2012-07-20,14,Friday,July,2012,False,14,19773
2012-07-21,0,Saturday,July,2012,True,0,19773
2012-07-22,0,Sunday,July,2012,True,0,19773
2012-07-23,18,Monday,July,2012,False,18,19791
2012-07-24,11,Tuesday,July,2012,False,11,19802
2012-07-25,14,Wednesday,July,2012,False,14,19816
2012-07-26,24,Thursday,July,2012,False,24,19840
2012-07-27,7,Friday,July,2012,False,7,19847
2012-07-28,,Saturday,July,2012,True,0,19847
2012-07-29,1,Sunday,July,2012,True,1,19848
2012-07-30,24,Monday,July,2012,False,24,19872
2012-07-31,13,Tuesday,July,2012,False,13,19885
2012-08-01,11,Wednesday,August,2012,False,11,19896
2012-08-02,19,Thursday,August,2012,False,19,19915
2012-08-03,6,Friday,August,2012,False,6,19921
2012-08-04,1,Saturday,August,2012,True,1,19922
2012-08-05,3,Sunday,August,2012,True,3,19925
2012-08-06,15,Monday,August,2012,False,15,19940
2012-08-07,22,Tuesday,August,2012,False,22,19962
2012-08-08,18,Wednesday,August,2012,False,18,19980
2012-08-09,13,Thursday,August,2012,False,13,19993
2012-08-10,7,Friday,August,2012,False,7,20000
2012-08-11,2,Saturday,August,2012,True,2,20002
2012-08-12,2,Sunday,August,2012,True,2,20004
2012-08-13,11,Monday,August,2012,False,11,20015
2012-08-14,16,Tuesday,August,2012,False,16,20031
2012-08-15,14,Wednesday,August,2012,False,14,20045
2012-08-16,10,Thursday,August,2012,False,10,20055
2012-08-17,8,Friday,August,2012,False,8,20063
2012-08-18,4,Saturday,August,2012,True,4,20067
2012-08-19,1,Sunday,August,2012,True,1,20068
2012-08-20,9,Monday,August,2012,False,9,20077
2012-08-21,5,Tuesday,August,2012,False,5,20082
2012-08-22,13,Wednesday,August,2012,False,13,20095
2012-08-23,13,Thursday,August,2012,False,13,20108
2012-08-24,9,Friday,August,2012,False,9,20117
2012-08-25,1,Saturday,August,2012,True,1,20118
2012-08-26,2,Sunday,August,2012,True,2,20120
2012-08-27,26,Monday,August,2012,False,26,20146
2012-08-28,25,Tuesday,August,2012,False,25,20171
2012-08-29,12,Wednesday,August,2012,False,12,20183
2012-08-30,12,Thursday,August,2012,False,12,20195
2012-08-31,8,Friday,August,2012,False,8,20203
2012-09-01,1,Saturday,September,2012,True,1,20204
2012-09-02,1,Sunday,September,2012,True,1,20205
2012-09-03,13,Monday,September,2012,False,13,20218
2012-09-04,16,Tuesday,September,2012,False,16,20234
2012-09-05,12,Wednesday,September,2012,False,12,20246
2012-09-06,16,Thursday,September,2012,False,16,20262
2012-09-07,4,Friday,September,2012,False,4,20266
2012-09-08,1,Saturday,September,2012,True,1,20267
2012-09-09,0,Sunday,September,2012,True,0,20267
2012-09-10,25,Monday,September,2012,False,25,20292
2012-09-11,20,Tuesday,September,2012,False,20,20312
2012-09-12,24,Wednesday,September,2012,False,24,20336
2012-09-13,14,Thursday,September,2012,False,14,20350
2012-09-14,8,Friday,September,2012,False,8,20358
2012-09-15,3,Saturday,September,2012,True,3,20361
2012-09-16,2,Sunday,September,2012,True,2,20363
2012-09-17,28,Monday,September,2012,False,28,20391
2012-09-18,15,Tuesday,September,2012,False,15,20406
2012-09-19,9,Wednesday,September,2012,False,9,20415
2012-09-20,13,Thursday,September,2012,False,13,20428
2012-09-21,6,Friday,September,2012,False,6,20434
2012-09-22,2,Saturday,September,2012,True,2,20436
2012-09-23,1,Sunday,September,2012,True,1,20437
2012-09-24,17,Monday,September,2012,False,17,20454
2012-09-25,14,Tuesday,September,2012,False,14,20468
2012-09-26,7,Wednesday,September,2012,False,7,20475
2012-09-27,19,Thursday,September,2012,False,19,20494
2012-09-28,7,Friday,September,2012,False,7,20501
2012-09-29,1,Saturday,September,2012,True,1,20502
2012-09-30,1,Sunday,September,2012,True,1,20503
2012-10-01,4,Monday,October,2012,False,4,20507
2012-10-02,16,Tuesday,October,2012,False,16,20523
2012-10-03,10,Wednesday,October,2012,False,10,20533
2012-10-04,18,Thursday,October,2012,False,18,20551
2012-10-05,4,Friday,October,2012,False,4,20555
2012-10-06,3,Saturday,October,2012,True,3,20558
2012-10-07,2,Sunday,October,2012,True,2,20560
2012-10-08,17,Monday,October,2012,False,17,20577
2012-10-09,25,Tuesday,October,2012,False,25,20602
2012-10-10,15,Wednesday,October,2012,False,15,20617
2012-10-11,21,Thursday,October,2012,False,21,20638
2012-10-12,15,Friday,October,2012,False,15,20653
2012-10-13,2,Saturday,October,2012,True,2,20655
2012-10-14,3,Sunday,October,2012,True,3,20658
2012-10-15,21,Monday,October,2012,False,21,20679
2012-10-16,17,Tuesday,October,2012,False,17,20696
2012-10-17,15,Wednesday,October,2012,False,15,20711
2012-10-18,23,Thursday,October,2012,False,23,20734
2012-10-19,14,Friday,October,2012,False,14,20748
2012-10-20,3,Saturday,October,2012,True,3,20751
2012-10-21,4,Sunday,October,2012,True,4,20755
2012-10-22,19,Monday,October,2012,False,19,20774
2012-10-23,21,Tuesday,October,2012,False,21,20795
2012-10-24,7,Wednesday,October,2012,False,7,20802
2012-10-25,2,Thursday,October,2012,False,2,20804
2012-10-26,5,Friday,October,2012,False,5,20809
2012-10-27,0,Saturday,October,2012,True,0,20809
2012-10-28,1,Sunday,October,2012,True,1,20810
2012-10-29,26,Monday,October,2012,False,26,20836
2012-10-30,33,Tuesday,October,2012,False,33,20869
2012-10-31,21,Wednesday,October,2012,False,21,20890
2012-11-01,17,Thursday,November,2012,False,17,20907
2012-11-02,9,Friday,November,2012,False,9,20916
2012-11-03,0,Saturday,November,2012,True,0,20916
2012-11-04,2,Sunday,November,2012,True,2,20918
2012-11-05,15,Monday,November,2012,False,15,20933
2012-11-06,22,Tuesday,November,2012,False,22,20955
2012-11-07,19,Wednesday,November,2012,False,19,20974
2012-11-08,20,Thursday,November,2012,False,20,20994
2012-11-09,1,Friday,November,2012,False,1,20995
2012-11-10,0,Saturday,November,2012,True,0,20995
2012-11-11,1,Sunday,November,2012,True,1,20996
2012-11-12,29,Monday,November,2012,False,29,21025
2012-11-13,15,Tuesday,November,2012,False,15,21040
2012-11-14,16,Wednesday,November,2012,False,16,21056
2012-11-15,17,Thursday,November,2012,False,17,21073
2012-11-16,9,Friday,November,2012,False,9,21082
2012-11-17,0,Saturday,November,2012,True,0,21082
2012-11-18,2,Sunday,November,2012,True,2,21084
2012-11-19,21,Monday,November,2012,False,21,21105
2012-11-20,17,Tuesday,November,2012,False,17,21122
2012-11-21,12,Wednesday,November,2012,False,12,21134
2012-11-22,11,Thursday,November,2012,False,11,21145
2012-11-23,11,Friday,November,2012,False,11,21156
2012-11-24,0,Saturday,November,2012,True,0,21156
2012-11-25,0,Sunday,November,2012,True,0,21156
2012-11-26,27,Monday,November,2012,False,27,21183
2012-11-27,15,Tuesday,November,2012,False,15,21198
2012-11-28,18,Wednesday,November,2012,False,18,21216
2012-11-29,17,Thursday,November,2012,False,17,21233
2012-11-30,16,Friday,November,2012,False,16,21249
2012-12-01,0,Saturday,December,2012,True,0,21249
2012-12-02,0,Sunday,December,2012,True,0,21249
2012-12-03,29,Monday,December,2012,False,29,21278
2012-12-04,26,Tuesday,December,2012,False,26,21304
2012-12-05,10,Wednesday,December,2012,False,10,21314
2012-12-06,18,Thursday,December,2012,False,18,21332
2012-12-07,5,Friday,December,2012,False,5,21337
2012-12-08,2,Saturday,December,2012,True,2,21339
2012-12-09,1,Sunday,December,2012,True,1,21340
2012-12-10,14,Monday,December,2012,False,14,21354
2012-12-11,9,Tuesday,December,2012,False,9,21363
2012-12-12,19,Wednesday,December,2012,False,19,21382
2012-12-13,14,Thursday,December,2012,False,14,21396
2012-12-14,10,Friday,December,2012,False,10,21406
2012-12-15,2,Saturday,December,2012,True,2,21408
2012-12-16,1,Sunday,December,2012,True,1,21409
2012-12-17,26,Monday,December,2012,False,26,21435
2012-12-18,15,Tuesday,December,2012,False,15,21450
2012-12-19,8,Wednesday,December,2012,False,8,21458
2012-12-20,14,Thursday,December,2012,False,14,21472
2012-12-21,8,Friday,December,2012,False,8,21480
2012-12-22,3,Saturday,December,2012,True,3,21483
2012-12-23,0,Sunday,December,2012,True,0,21483
2012-12-24,9,Monday,December,2012,False,9,21492
2012-12-25,0,Tuesday,December,2012,False,0,21492
2012-12-26,2,Wednesday,December,2012,False,2,21494
2012-12-27,5,Thursday,December,2012,False,5,21499
2012-12-28,4,Friday,December,2012,False,4,21503
2012-12-29,0,Saturday,December,2012,True,0,21503
2012-12-30,0,Sunday,December,2012,True,0,21503
2012-12-31,7,Monday,December,2012,False,7,21510
2013-01-01,11,Tuesday,January,2013,False,11,21521
2013-01-02,2,Wednesday,January,2013,False,2,21523
2013-01-03,10,Thursday,January,2013,False,10,21533
2013-01-04,4,Friday,January,2013,False,4,21537
2013-01-05,1,Saturday,January,2013,True,1,21538
2013-01-06,1,Sunday,January,2013,True,1,21539
2013-01-07,29,Monday,January,2013,False,29,21568
2013-01-08,16,Tuesday,January,2013,False,16,21584
2013-01-09,20,Wednesday,January,2013,False,20,21604
2013-01-10,16,Thursday,January,2013,False,16,21620
2013-01-11,12,Friday,January,2013,False,12,21632
2013-01-12,0,Saturday,January,2013,True,0,21632
2013-01-13,0,Sunday,January,2013,True,0,21632
2013-01-14,27,Monday,January,2013,False,27,21659
2013-01-15,33,Tuesday,January,2013,False,33,21692
2013-01-16,11,Wednesday,January,2013,False,11,21703
2013-01-17,17,Thursday,January,2013,False,17,21720
2013-01-18,10,Friday,January,2013,False,10,21730
2013-01-19,1,Saturday,January,2013,True,1,21731
2013-01-20,2,Sunday,January,2013,True,2,21733
2013-01-21,19,Monday,January,2013,False,19,21752
2013-01-22,13,Tuesday,January,2013,False,13,21765
2013-01-23,10,Wednesday,January,2013,False,10,21775
2013-01-24,4,Thursday,January,2013,False,4,21779
2013-01-25,7,Friday,January,2013,False,7,21786
2013-01-26,2,Saturday,January,2013,True,2,21788
2013-01-27,0,Sunday,January,2013,True,0,21788
2013-01-28,12,Monday,January,2013,False,12,21800
2013-01-29,14,Tuesday,January,2013,False,14,21814
2013-01-30,10,Wednesday,January,2013,False,10,21824
2013-01-31,16,Thursday,January,2013,False,16,21840
2013-02-01,7,Friday,February,2013,False,7,21847
2013-02-02,3,Saturday,February,2013,True,3,21850
2013-02-03,1,Sunday,February,2013,True,1,21851
2013-02-04,20,Monday,February,2013,False,20,21871
2013-02-05,23,Tuesday,February,2013,False,23,21894
2013-02-06,17,Wednesday,February,2013,False,17,21911
2013-02-07,12,Thursday,February,2013,False,12,21923
2013-02-08,13,Friday,February,2013,False,13,21936
2013-02-09,5,Saturday,February,2013,True,5,21941
2013-02-10,0,Sunday,February,2013,True,0,21941
2013-02-11,19,Monday,February,2013,False,19,21960
2013-02-12,9,Tuesday,February,2013,False,9,21969
2013-02-13,9,Wednesday,February,2013,False,9,21978
2013-02-14,15,Thursday,February,2013,False,15,21993
2013-02-15,9,Friday,February,2013,False,9,22002
2013-02-16,1,Saturday,February,2013,True,1,22003
2013-02-17,0,Sunday,February,2013,True,0,22003
2013-02-18,18,Monday,February,2013,False,18,22021
2013-02-19,16,Tuesday,February,2013,False,16,22037
2013-02-20,18,Wednesday,February,2013,False,18,22055
2013-02-21,19,Thursday,February,2013,False,19,22074
2013-02-22,3,Friday,February,2013,False,3,22077
2013-02-23,1,Saturday,February,2013,True,1,22078
2013-02-24,1,Sunday,February,2013,True,1,22079
2013-02-25,20,Monday,February,2013,False,20,22099
2013-02-26,14,Tuesday,February,2013,False,14,22113
2013-02-27,11,Wednesday,February,2013,False,11,22124
2013-02-28,11,Thursday,February,2013,False,11,22135
2013-03-01,5,Friday,March,2013,False,5,22140
2013-03-02,2,Saturday,March,2013,True,2,22142
2013-03-03,0,Sunday,March,2013,True,0,22142
2013-03-04,17,Monday,March,2013,False,17,22159
2013-03-05,16,Tuesday,March,2013,False,16,22175
2013-03-06,18,Wednesday,March,2013,False,18,22193
2013-03-07,17,Thursday,March,2013,False,17,22210
2013-03-08,4,Friday,March,2013,False,4,22214
2013-03-09,2,Saturday,March,2013,True,2,22216
2013-03-10,2,Sunday,March,2013,True,2,22218
2013-03-11,20,Monday,March,2013,False,20,22238
2013-03-12,18,Tuesday,March,2013,False,18,22256
2013-03-13,12,Wednesday,March,2013,False,12,22268
2013-03-14,10,Thursday,March,2013,False,10,22278
2013-03-15,14,Friday,March,2013,False,14,22292
2013-03-16,1,Saturday,March,2013,True,1,22293
2013-03-17,1,Sunday,March,2013,True,1,22294
2013-03-18,20,Monday,March,2013,False,20,22314
2013-03-19,20,Tuesday,March,2013,False,20,22334
2013-03-20,15,Wednesday,March,2013,False,15,22349
2013-03-21,16,Thursday,March,2013,False,16,22365
2013-03-22,3,Friday,March,2013,False,3,22368
2013-03-23,1,Saturday,March,2013,True,1,22369
2013-03-24,0,Sunday,March,2013,True,0,22369
2013-03-25,15,Monday,March,2013,False,15,22384
2013-03-26,17,Tuesday,March,2013,False,17,22401
2013-03-27,18,Wednesday,March,2013,False,18,22419
2013-03-28,13,Thursday,March,2013,False,13,22432
2013-03-29,1,Friday,March,2013,False,1,22433
2013-03-30,0,Saturday,March,2013,True,0,22433
2013-03-31,,Sunday,March,2013,True,0,22433
2013-04-01,5,Monday,April,2013,False,5,22438
2013-04-02,17,Tuesday,April,2013,False,17,22455
2013-04-03,13,Wednesday,April,2013,False,13,22468
2013-04-04,16,Thursday,April,2013,False,16,22484
2013-04-05,10,Friday,April,2013,False,10,22494
2013-04-06,1,Saturday,April,2013,True,1,22495
2013-04-07,4,Sunday,April,2013,True,4,22499
2013-04-08,20,Monday,April,2013,False,20,22519
2013-04-09,14,Tuesday,April,2013,False,14,22533
2013-04-10,16,Wednesday,April,2013,False,16,22549
2013-04-11,13,Thursday,April,2013,False,13,22562
2013-04-12,8,Friday,April,2013,False,8,22570
2013-04-13,2,Saturday,April,2013,True,2,22572
2013-04-14,5,Sunday,April,2013,True,5,22577
2013-04-15,13,Monday,April,2013,False,13,22590
2013-04-16,15,Tuesday,April,2013,False,15,22605
2013-04-17,13,Wednesday,April,2013,False,13,22618
2013-04-18,28,Thursday,April,2013,False,28,22646
2013-04-19,5,Friday,April,2013,False,5,22651
2013-04-20,2,Saturday,April,2013,True,2,22653
2013-04-21,4,Sunday,April,2013,True,4,22657
2013-04-22,13,Monday,April,2013,False,13,22670
2013-04-23,12,Tuesday,April,2013,False,12,22682
2013-04-24,9,Wednesday,April,2013,False,9,22691
2013-04-25,11,Thursday,April,2013,False,11,22702
2013-04-26,6,Friday,April,2013,False,6,22708
2013-04-27,0,Saturday,April,2013,True,0,22708
2013-04-28,0,Sunday,April,2013,True,0,22708
2013-04-29,18,Monday,April,2013,False,18,22726
2013-04-30,12,Tuesday,April,2013,False,12,22738
2013-05-01,4,Wednesday,May,2013,False,4,22742
2013-05-02,14,Thursday,May,2013,False,14,22756
2013-05-03,4,Friday,May,2013,False,4,22760
2013-05-04,1,Saturday,May,2013,True,1,22761
2013-05-05,5,Sunday,May,2013,True,5,22766
2013-05-06,19,Monday,May,2013,False,19,22785
2013-05-07,12,Tuesday,May,2013,False,12,22797
2013-05-08,10,Wednesday,May,2013,False,10,22807
2013-05-09,12,Thursday,May,2013,False,12,22819
2013-05-10,9,Friday,May,2013,False,9,22828
2013-05-11,0,Saturday,May,2013,True,0,22828
2013-05-12,1,Sunday,May,2013,True,1,22829
2013-05-13,13,Monday,May,2013,False,13,22842
2013-05-14,17,Tuesday,May,2013,False,17,22859
2013-05-15,10,Wednesday,May,2013,False,10,22869
2013-05-16,13,Thursday,May,2013,False,13,22882
2013-05-17,2,Friday,May,2013,False,2,22884
2013-05-18,0,Saturday,May,2013,True,0,22884
2013-05-19,0,Sunday,May,2013,True,0,22884
2013-05-20,17,Monday,May,2013,False,17,22901
2013-05-21,22,Tuesday,May,2013,False,22,22923
2013-05-22,12,Wednesday,May,2013,False,12,22935
2013-05-23,24,Thursday,May,2013,False,24,22959
2013-05-24,4,Friday,May,2013,False,4,22963
2013-05-25,1,Saturday,May,2013,True,1,22964
2013-05-26,1,Sunday,May,2013,True,1,22965
2013-05-27,10,Monday,May,2013,False,10,22975
2013-05-28,10,Tuesday,May,2013,False,10,22985
2013-05-29,7,Wednesday,May,2013,False,7,22992
2013-05-30,17,Thursday,May,2013,False,17,23009
2013-05-31,8,Friday,May,2013,False,8,23017
2013-06-01,0,Saturday,June,2013,True,0,23017
2013-06-02,2,Sunday,June,2013,True,2,23019
2013-06-03,11,Monday,June,2013,False,11,23030
2013-06-04,16,Tuesday,June,2013,False,16,23046
2013-06-05,15,Wednesday,June,2013,False,15,23061
2013-06-06,18,Thursday,June,2013,False,18,23079
2013-06-07,11,Friday,June,2013,False,11,23090
2013-06-08,2,Saturday,June,2013,True,2,23092
2013-06-09,0,Sunday,June,2013,True,0,23092
2013-06-10,19,Monday,June,2013,False,19,23111
2013-06-11,20,Tuesday,June,2013,False,20,23131
2013-06-12,23,Wednesday,June,2013,False,23,23154
2013-06-13,15,Thursday,June,2013,False,15,23169
2013-06-14,12,Friday,June,2013,False,12,23181
2013-06-15,2,Saturday,June,2013,True,2,23183
2013-06-16,2,Sunday,June,2013,True,2,23185
2013-06-17,21,Monday,June,2013,False,21,23206
2013-06-18,35,Tuesday,June,2013,False,35,23241
2013-06-19,17,Wednesday,June,2013,False,17,23258
2013-06-20,19,Thursday,June,2013,False,19,23277
2013-06-21,6,Friday,June,2013,False,6,23283
2013-06-22,4,Saturday,June,2013,True,4,23287
2013-06-23,2,Sunday,June,2013,True,2,23289
2013-06-24,25,Monday,June,2013,False,25,23314
2013-06-25,19,Tuesday,June,2013,False,19,23333
2013-06-26,16,Wednesday,June,2013,False,16,23349
2013-06-27,15,Thursday,June,2013,False,15,23364
2013-06-28,3,Friday,June,2013,False,3,23367
2013-06-29,3,Saturday,June,2013,True,3,23370
2013-06-30,1,Sunday,June,2013,True,1,23371
2013-07-01,29,Monday,July,2013,False,29,23400
2013-07-02,22,Tuesday,July,2013,False,22,23422
2013-07-03,14,Wednesday,July,2013,False,14,23436
2013-07-04,18,Thursday,July,2013,False,18,23454
2013-07-05,9,Friday,July,2013,False,9,23463
2013-07-06,1,Saturday,July,2013,True,1,23464
2013-07-07,1,Sunday,July,2013,True,1,23465
2013-07-08,24,Monday,July,2013,False,24,23489
2013-07-09,35,Tuesday,July,2013,False,35,23524
2013-07-10,26,Wednesday,July,2013,False,26,23550
2013-07-11,16,Thursday,July,2013,False,16,23566
2013-07-12,12,Friday,July,2013,False,12,23578
2013-07-13,2,Saturday,July,2013,True,2,23580
2013-07-14,1,Sunday,July,2013,True,1,23581
2013-07-15,20,Monday,July,2013,False,20,23601
2013-07-16,30,Tuesday,July,2013,False,30,23631
2013-07-17,10,Wednesday,July,2013,False,10,23641
2013-07-18,14,Thursday,July,2013,False,14,23655
2013-07-19,13,Friday,July,2013,False,13,23668
2013-07-20,3,Saturday,July,2013,True,3,23671
2013-07-21,1,Sunday,July,2013,True,1,23672
2013-07-22,30,Monday,July,2013,False,30,23702
2013-07-23,30,Tuesday,July,2013,False,30,23732
2013-07-24,17,Wednesday,July,2013,False,17,23749
2013-07-25,26,Thursday,July,2013,False,26,23775
2013-07-26,14,Friday,July,2013,False,14,23789
2013-07-27,3,Saturday,July,2013,True,3,23792
2013-07-28,0,Sunday,July,2013,True,0,23792
2013-07-29,23,Monday,July,2013,False,23,23815
2013-07-30,28,Tuesday,July,2013,False,28,23843
2013-07-31,15,Wednesday,July,2013,False,15,23858
2013-08-01,18,Thursday,August,2013,False,18,23876
2013-08-02,10,Friday,August,2013,False,10,23886
2013-08-03,3,Saturday,August,2013,True,3,23889
2013-08-04,1,Sunday,August,2013,True,1,23890
2013-08-05,35,Monday,August,2013,False,35,23925
2013-08-06,19,Tuesday,August,2013,False,19,23944
2013-08-07,16,Wednesday,August,2013,False,16,23960
2013-08-08,10,Thursday,August,2013,False,10,23970
2013-08-09,8,Friday,August,2013,False,8,23978
2013-08-10,6,Saturday,August,2013,True,6,23984
2013-08-11,3,Sunday,August,2013,True,3,23987
2013-08-12,30,Monday,August,2013,False,30,24017
2013-08-13,36,Tuesday,August,2013,False,36,24053
2013-08-14,17,Wednesday,August,2013,False,17,24070
2013-08-15,14,Thursday,August,2013,False,14,24084
2013-08-16,12,Friday,August,2013,False,12,24096
2013-08-17,0,Saturday,August,2013,True,0,24096
2013-08-18,3,Sunday,August,2013,True,3,24099
2013-08-19,22,Monday,August,2013,False,22,24121
2013-08-20,35,Tuesday,August,2013,False,35,24156
2013-08-21,16,Wednesday,August,2013,False,16,24172
2013-08-22,18,Thursday,August,2013,False,18,24190
2013-08-23,8,Friday,August,2013,False,8,24198
2013-08-24,3,Saturday,August,2013,True,3,24201
2013-08-25,5,Sunday,August,2013,True,5,24206
2013-08-26,19,Monday,August,2013,False,19,24225
2013-08-27,14,Tuesday,August,2013,False,14,24239
2013-08-28,14,Wednesday,August,2013,False,14,24253
2013-08-29,8,Thursday,August,2013,False,8,24261
2013-08-30,11,Friday,August,2013,False,11,24272
2013-08-31,,Saturday,August,2013,True,0,24272
2013-09-01,3,Sunday,September,2013,True,3,24275
2013-09-02,19,Monday,September,2013,False,19,24294
2013-09-03,23,Tuesday,September,2013,False,23,24317
2013-09-04,14,Wednesday,September,2013,False,14,24331
2013-09-05,22,Thursday,September,2013,False,22,24353
2013-09-06,15,Friday,September,2013,False,15,24368
2013-09-07,2,Saturday,September,2013,True,2,24370
2013-09-08,1,Sunday,September,2013,True,1,24371
2013-09-09,23,Monday,September,2013,False,23,24394
2013-09-10,28,Tuesday,September,2013,False,28,24422
2013-09-11,15,Wednesday,September,2013,False,15,24437
2013-09-12,20,Thursday,September,2013,False,20,24457
2013-09-13,10,Friday,September,2013,False,10,24467
2013-09-14,4,Saturday,September,2013,True,4,24471
2013-09-15,1,Sunday,September,2013,True,1,24472
2013-09-16,18,Monday,September,2013,False,18,24490
2013-09-17,25,Tuesday,September,2013,False,25,24515
2013-09-18,18,Wednesday,September,2013,False,18,24533
2013-09-19,16,Thursday,September,2013,False,16,24549
2013-09-20,7,Friday,September,2013,False,7,24556
2013-09-21,2,Saturday,September,2013,True,2,24558
2013-09-22,2,Sunday,September,2013,True,2,24560
2013-09-23,21,Monday,September,2013,False,21,24581
2013-09-24,30,Tuesday,September,2013,False,30,24611
2013-09-25,10,Wednesday,September,2013,False,10,24621
2013-09-26,13,Thursday,September,2013,False,13,24634
2013-09-27,13,Friday,September,2013,False,13,24647
2013-09-28,3,Saturday,September,2013,True,3,24650
2013-09-29,2,Sunday,September,2013,True,2,24652
2013-09-30,22,Monday,September,2013,False,22,24674
2013-10-01,3,Tuesday,October,2013,False,3,24677
2013-10-02,29,Wednesday,October,2013,False,29,24706
2013-10-03,22,Thursday,October,2013,False,22,24728
2013-10-04,15,Friday,October,2013,False,15,24743
2013-10-05,3,Saturday,October,2013,True,3,24746
2013-10-06,4,Sunday,October,2013,True,4,24750
2013-10-07,19,Monday,October,2013,False,19,24769
2013-10-08,22,Tuesday,October,2013,False,22,24791
2013-10-09,21,Wednesday,October,2013,False,21,24812
2013-10-10,19,Thursday,October,2013,False,19,24831
2013-10-11,11,Friday,October,2013,False,11,24842
2013-10-12,0,Saturday,October,2013,True,0,24842
2013-10-13,0,Sunday,October,2013,True,0,24842
2013-10-14,24,Monday,October,2013,False,24,24866
2013-10-15,9,Tuesday,October,2013,False,9,24875
2013-10-16,6,Wednesday,October,2013,False,6,24881
2013-10-17,35,Thursday,October,2013,False,35,24916
2013-10-18,19,Friday,October,2013,False,19,24935
2013-10-19,3,Saturday,October,2013,True,3,24938
2013-10-20,0,Sunday,October,2013,True,0,24938
2013-10-21,26,Monday,October,2013,False,26,24964
2013-10-22,22,Tuesday,October,2013,False,22,24986
2013-10-23,14,Wednesday,October,2013,False,14,25000
2013-10-24,19,Thursday,October,2013,False,19,25019
2013-10-25,12,Friday,October,2013,False,12,25031
2013-10-26,3,Saturday,October,2013,True,3,25034
2013-10-27,1,Sunday,October,2013,True,1,25035
2013-10-28,13,Monday,October,2013,False,13,25048
2013-10-29,21,Tuesday,October,2013,False,21,25069
2013-10-30,16,Wednesday,October,2013,False,16,25085
2013-10-31,15,Thursday,October,2013,False,15,25100
2013-11-01,9,Friday,November,2013,False,9,25109
2013-11-02,2,Saturday,November,2013,True,2,25111
2013-11-03,0,Sunday,November,2013,True,0,25111
2013-11-04,27,Monday,November,2013,False,27,25138
2013-11-05,32,Tuesday,November,2013,False,32,25170
2013-11-06,12,Wednesday,November,2013,False,12,25182
2013-11-07,16,Thursday,November,2013,False,16,25198
2013-11-08,16,Friday,November,2013,False,16,25214
2013-11-09,4,Saturday,November,2013,True,4,25218
2013-11-10,0,Sunday,November,2013,True,0,25218
2013-11-11,18,Monday,November,2013,False,18,25236
2013-11-12,25,Tuesday,November,2013,False,25,25261
2013-11-13,6,Wednesday,November,2013,False,6,25267
2013-11-14,15,Thursday,November,2013,False,15,25282
2013-11-15,8,Friday,November,2013,False,8,25290
2013-11-16,2,Saturday,November,2013,True,2,25292
2013-11-17,1,Sunday,November,2013,True,1,25293
2013-11-18,26,Monday,November,2013,False,26,25319
2013-11-19,19,Tuesday,November,2013,False,19,25338
2013-11-20,16,Wednesday,November,2013,False,16,25354
2013-11-21,18,Thursday,November,2013,False,18,25372
2013-11-22,9,Friday,November,2013,False,9,25381
2013-11-23,3,Saturday,November,2013,True,3,25384
2013-11-24,0,Sunday,November,2013,True,0,25384
2013-11-25,15,Monday,November,2013,False,15,25399
2013-11-26,12,Tuesday,November,2013,False,12,25411
2013-11-27,14,Wednesday,November,2013,False,14,25425
2013-11-28,13,Thursday,November,2013,False,13,25438
2013-11-29,11,Friday,November,2013,False,11,25449
2013-11-30,1,Saturday,November,2013,True,1,25450
2013-12-01,1,Sunday,December,2013,True,1,25451
2013-12-02,17,Monday,December,2013,False,17,25468
2013-12-03,23,Tuesday,December,2013,False,23,25491
2013-12-04,11,Wednesday,December,2013,False,11,25502
2013-12-05,16,Thursday,December,2013,False,16,25518
2013-12-06,16,Friday,December,2013,False,16,25534
2013-12-07,1,Saturday,December,2013,True,1,25535
2013-12-08,1,Sunday,December,2013,True,1,25536
2013-12-09,18,Monday,December,2013,False,18,25554
2013-12-10,19,Tuesday,December,2013,False,19,25573
2013-12-11,14,Wednesday,December,2013,False,14,25587
2013-12-12,31,Thursday,December,2013,False,31,25618
2013-12-13,10,Friday,December,2013,False,10,25628
2013-12-14,1,Saturday,December,2013,True,1,25629
2013-12-15,0,Sunday,December,2013,True,0,25629
2013-12-16,9,Monday,December,2013,False,9,25638
2013-12-17,22,Tuesday,December,2013,False,22,25660
2013-12-18,11,Wednesday,December,2013,False,11,25671
2013-12-19,7,Thursday,December,2013,False,7,25678
2013-12-20,9,Friday,December,2013,False,9,25687
2013-12-21,0,Saturday,December,2013,True,0,25687
2013-12-22,0,Sunday,December,2013,True,0,25687
2013-12-23,7,Monday,December,2013,False,7,25694
2013-12-24,8,Tuesday,December,2013,False,8,25702
2013-12-25,0,Wednesday,December,2013,False,0,25702
2013-12-26,1,Thursday,December,2013,False,1,25703
2013-12-27,4,Friday,December,2013,False,4,25707
2013-12-28,2,Saturday,December,2013,True,2,25709
2013-12-29,0,Sunday,December,2013,True,0,25709
2013-12-30,7,Monday,December,2013,False,7,25716
2013-12-31,7,Tuesday,December,2013,False,7,25723
2014-01-01,11,Wednesday,January,2014,False,11,25734
2014-01-02,3,Thursday,January,2014,False,3,25737
2014-01-03,10,Friday,January,2014,False,10,25747
2014-01-04,2,Saturday,January,2014,True,2,25749
2014-01-05,4,Sunday,January,2014,True,4,25753
2014-01-06,23,Monday,January,2014,False,23,25776
2014-01-07,27,Tuesday,January,2014,False,27,25803
2014-01-08,15,Wednesday,January,2014,False,15,25818
2014-01-09,25,Thursday,January,2014,False,25,25843
2014-01-10,12,Friday,January,2014,False,12,25855
2014-01-11,1,Saturday,January,2014,True,1,25856
2014-01-12,1,Sunday,January,2014,True,1,25857
2014-01-13,27,Monday,January,2014,False,27,25884
2014-01-14,16,Tuesday,January,2014,False,16,25900
2014-01-15,22,Wednesday,January,2014,False,22,25922
2014-01-16,27,Thursday,January,2014,False,27,25949
2014-01-17,17,Friday,January,2014,False,17,25966
2014-01-18,0,Saturday,January,2014,True,0,25966
2014-01-19,2,Sunday,January,2014,True,2,25968
2014-01-20,19,Monday,January,2014,False,19,25987
2014-01-21,28,Tuesday,January,2014,False,28,26015
2014-01-22,18,Wednesday,January,2014,False,18,26033
2014-01-23,25,Thursday,January,2014,False,25,26058
2014-01-24,13,Friday,January,2014,False,13,26071
2014-01-25,0,Saturday,January,2014,True,0,26071
2014-01-26,1,Sunday,January,2014,True,1,26072
2014-01-27,74,Monday,January,2014,False,74,26146
2014-01-28,18,Tuesday,January,2014,False,18,26164
2014-01-29,14,Wednesday,January,2014,False,14,26178
2014-01-30,18,Thursday,January,2014,False,18,26196
2014-01-31,14,Friday,January,2014,False,14,26210
2014-02-01,3,Saturday,February,2014,True,3,26213
2014-02-02,2,Sunday,February,2014,True,2,26215
2014-02-03,22,Monday,February,2014,False,22,26237
2014-02-04,23,Tuesday,February,2014,False,23,26260
2014-02-05,15,Wednesday,February,2014,False,15,26275
2014-02-06,31,Thursday,February,2014,False,31,26306
2014-02-07,11,Friday,February,2014,False,11,26317
2014-02-08,2,Saturday,February,2014,True,2,26319
2014-02-09,1,Sunday,February,2014,True,1,26320
2014-02-10,19,Monday,February,2014,False,19,26339
2014-02-11,35,Tuesday,February,2014,False,35,26374
2014-02-12,15,Wednesday,February,2014,False,15,26389
2014-02-13,26,Thursday,February,2014,False,26,26415
2014-02-14,13,Friday,February,2014,False,13,26428
2014-02-15,0,Saturday,February,2014,True,0,26428
2014-02-16,2,Sunday,February,2014,True,2,26430
2014-02-17,14,Monday,February,2014,False,14,26444
2014-02-18,30,Tuesday,February,2014,False,30,26474
2014-02-19,14,Wednesday,February,2014,False,14,26488
2014-02-20,26,Thursday,February,2014,False,26,26514
2014-02-21,14,Friday,February,2014,False,14,26528
2014-02-22,1,Saturday,February,2014,True,1,26529
2014-02-23,0,Sunday,February,2014,True,0,26529
2014-02-24,30,Monday,February,2014,False,30,26559
2014-02-25,35,Tuesday,February,2014,False,35,26594
2014-02-26,18,Wednesday,February,2014,False,18,26612
2014-02-27,21,Thursday,February,2014,False,21,26633
2014-02-28,14,Friday,February,2014,False,14,26647
2014-03-01,0,Saturday,March,2014,True,0,26647
2014-03-02,0,Sunday,March,2014,True,0,26647
2014-03-03,33,Monday,March,2014,False,33,26680
2014-03-04,32,Tuesday,March,2014,False,32,26712
2014-03-05,18,Wednesday,March,2014,False,18,26730
2014-03-06,32,Thursday,March,2014,False,32,26762
2014-03-07,16,Friday,March,2014,False,16,26778
2014-03-08,1,Saturday,March,2014,True,1,26779
2014-03-09,0,Sunday,March,2014,True,0,26779
2014-03-10,22,Monday,March,2014,False,22,26801
2014-03-11,17,Tuesday,March,2014,False,17,26818
2014-03-12,17,Wednesday,March,2014,False,17,26835
2014-03-13,15,Thursday,March,2014,False,15,26850
2014-03-14,16,Friday,March,2014,False,16,26866
2014-03-15,2,Saturday,March,2014,True,2,26868
2014-03-16,1,Sunday,March,2014,True,1,26869
2014-03-17,21,Monday,March,2014,False,21,26890
2014-03-18,25,Tuesday,March,2014,False,25,26915
2014-03-19,9,Wednesday,March,2014,False,9,26924
2014-03-20,22,Thursday,March,2014,False,22,26946
2014-03-21,14,Friday,March,2014,False,14,26960
2014-03-22,2,Saturday,March,2014,True,2,26962
2014-03-23,6,Sunday,March,2014,True,6,26968
2014-03-24,23,Monday,March,2014,False,23,26991
2014-03-25,22,Tuesday,March,2014,False,22,27013
2014-03-26,15,Wednesday,March,2014,False,15,27028
2014-03-27,12,Thursday,March,2014,False,12,27040
2014-03-28,10,Friday,March,2014,False,10,27050
2014-03-29,0,Saturday,March,2014,True,0,27050
2014-03-30,2,Sunday,March,2014,True,2,27052
2014-03-31,12,Monday,March,2014,False,12,27064
2014-04-01,19,Tuesday,April,2014,False,19,27083
2014-04-02,13,Wednesday,April,2014,False,13,27096
2014-04-03,10,Thursday,April,2014,False,10,27106
2014-04-04,6,Friday,April,2014,False,6,27112
2014-04-05,2,Saturday,April,2014,True,2,27114
2014-04-06,0,Sunday,April,2014,True,0,27114
2014-04-07,15,Monday,April,2014,False,15,27129
2014-04-08,23,Tuesday,April,2014,False,23,27152
2014-04-09,15,Wednesday,April,2014,False,15,27167
2014-04-10,16,Thursday,April,2014,False,16,27183
2014-04-11,5,Friday,April,2014,False,5,27188
2014-04-12,1,Saturday,April,2014,True,1,27189
2014-04-13,1,Sunday,April,2014,True,1,27190
2014-04-14,18,Monday,April,2014,False,18,27208
2014-04-15,19,Tuesday,April,2014,False,19,27227
2014-04-16,18,Wednesday,April,2014,False,18,27245
2014-04-17,15,Thursday,April,2014,False,15,27260
2014-04-18,6,Friday,April,2014,False,6,27266
2014-04-19,1,Saturday,April,2014,True,1,27267
2014-04-20,0,Sunday,April,2014,True,0,27267
2014-04-21,3,Monday,April,2014,False,3,27270
2014-04-22,21,Tuesday,April,2014,False,21,27291
2014-04-23,15,Wednesday,April,2014,False,15,27306
2014-04-24,23,Thursday,April,2014,False,23,27329
2014-04-25,12,Friday,April,2014,False,12,27341
2014-04-26,1,Saturday,April,2014,True,1,27342
2014-04-27,2,Sunday,April,2014,True,2,27344
2014-04-28,14,Monday,April,2014,False,14,27358
2014-04-29,26,Tuesday,April,2014,False,26,27384
2014-04-30,16,Wednesday,April,2014,False,16,27400
2014-05-01,4,Thursday,May,2014,False,4,27404
2014-05-02,20,Friday,May,2014,False,20,27424
2014-05-03,2,Saturday,May,2014,True,2,27426
2014-05-04,3,Sunday,May,2014,True,3,27429
2014-05-05,22,Monday,May,2014,False,22,27451
2014-05-06,26,Tuesday,May,2014,False,26,27477
2014-05-07,13,Wednesday,May,2014,False,13,27490
2014-05-08,16,Thursday,May,2014,False,16,27506
2014-05-09,10,Friday,May,2014,False,10,27516
2014-05-10,3,Saturday,May,2014,True,3,27519
2014-05-11,2,Sunday,May,2014,True,2,27521
2014-05-12,26,Monday,May,2014,False,26,27547
2014-05-13,17,Tuesday,May,2014,False,17,27564
2014-05-14,12,Wednesday,May,2014,False,12,27576
2014-05-15,25,Thursday,May,2014,False,25,27601
2014-05-16,8,Friday,May,2014,False,8,27609
2014-05-17,5,Saturday,May,2014,True,5,27614
2014-05-18,3,Sunday,May,2014,True,3,27617
2014-05-19,18,Monday,May,2014,False,18,27635
2014-05-20,20,Tuesday,May,2014,False,20,27655
2014-05-21,19,Wednesday,May,2014,False,19,27674
2014-05-22,16,Thursday,May,2014,False,16,27690
2014-05-23,8,Friday,May,2014,False,8,27698
2014-05-24,1,Saturday,May,2014,True,1,27699
2014-05-25,3,Sunday,May,2014,True,3,27702
2014-05-26,18,Monday,May,2014,False,18,27720
2014-05-27,16,Tuesday,May,2014,False,16,27736
2014-05-28,13,Wednesday,May,2014,False,13,27749
2014-05-29,6,Thursday,May,2014,False,6,27755
2014-05-30,4,Friday,May,2014,False,4,27759
2014-05-31,1,Saturday,May,2014,True,1,27760
2014-06-01,6,Sunday,June,2014,True,6,27766
2014-06-02,24,Monday,June,2014,False,24,27790
2014-06-03,27,Tuesday,June,2014,False,27,27817
2014-06-04,7,Wednesday,June,2014,False,7,27824
2014-06-05,23,Thursday,June,2014,False,23,27847
2014-06-06,10,Friday,June,2014,False,10,27857
2014-06-07,2,Saturday,June,2014,True,2,27859
2014-06-08,1,Sunday,June,2014,True,1,27860
2014-06-09,27,Monday,June,2014,False,27,27887
2014-06-10,20,Tuesday,June,2014,False,20,27907
2014-06-11,14,Wednesday,June,2014,False,14,27921
2014-06-12,23,Thursday,June,2014,False,23,27944
2014-06-13,7,Friday,June,2014,False,7,27951
2014-06-14,1,Saturday,June,2014,True,1,27952
2014-06-15,1,Sunday,June,2014,True,1,27953
2014-06-16,15,Monday,June,2014,False,15,27968
2014-06-17,22,Tuesday,June,2014,False,22,27990
2014-06-18,10,Wednesday,June,2014,False,10,28000
2014-06-19,16,Thursday,June,2014,False,16,28016
2014-06-20,10,Friday,June,2014,False,10,28026
2014-06-21,0,Saturday,June,2014,True,0,28026
2014-06-22,1,Sunday,June,2014,True,1,28027
2014-06-23,21,Monday,June,2014,False,21,28048
2014-06-24,14,Tuesday,June,2014,False,14,28062
2014-06-25,9,Wednesday,June,2014,False,9,28071
2014-06-26,17,Thursday,June,2014,False,17,28088
2014-06-27,9,Friday,June,2014,False,9,28097
2014-06-28,0,Saturday,June,2014,True,0,28097
2014-06-29,0,Sunday,June,2014,True,0,28097
2014-06-30,19,Monday,June,2014,False,19,28116
2014-07-01,21,Tuesday,July,2014,False,21,28137
2014-07-02,22,Wednesday,July,2014,False,22,28159
2014-07-03,15,Thursday,July,2014,False,15,28174
2014-07-04,9,Friday,July,2014,False,9,28183
2014-07-05,0,Saturday,July,2014,True,0,28183
2014-07-06,3,Sunday,July,2014,True,3,28186
2014-07-07,16,Monday,July,2014,False,16,28202
2014-07-08,32,Tuesday,July,2014,False,32,28234
2014-07-09,9,Wednesday,July,2014,False,9,28243
2014-07-10,8,Thursday,July,2014,False,8,28251
2014-07-11,16,Friday,July,2014,False,16,28267
2014-07-12,2,Saturday,July,2014,True,2,28269
2014-07-13,1,Sunday,July,2014,True,1,28270
2014-07-14,15,Monday,July,2014,False,15,28285
2014-07-15,33,Tuesday,July,2014,False,33,28318
2014-07-16,11,Wednesday,July,2014,False,11,28329
2014-07-17,7,Thursday,July,2014,False,7,28336
2014-07-18,8,Friday,July,2014,False,8,28344
2014-07-19,0,Saturday,July,2014,True,0,28344
2014-07-20,1,Sunday,July,2014,True,1,28345
2014-07-21,16,Monday,July,2014,False,16,28361
2014-07-22,29,Tuesday,July,2014,False,29,28390
2014-07-23,4,Wednesday,July,2014,False,4,28394
2014-07-24,29,Thursday,July,2014,False,29,28423
2014-07-25,9,Friday,July,2014,False,9,28432
2014-07-26,1,Saturday,July,2014,True,1,28433
2014-07-27,0,Sunday,July,2014,True,0,28433
2014-07-28,4,Monday,July,2014,False,4,28437
2014-07-29,3,Tuesday,July,2014,False,3,28440
2014-07-30,5,Wednesday,July,2014,False,5,28445
2014-07-31,2,Thursday,July,2014,False,2,28447
2014-08-01,6,Friday,August,2014,False,6,28453
2014-08-02,7,Saturday,August,2014,True,7,28460
2014-08-03,2,Sunday,August,2014,True,2,28462
2014-08-04,25,Monday,August,2014,False,25,28487
2014-08-05,26,Tuesday,August,2014,False,26,28513
2014-08-06,15,Wednesday,August,2014,False,15,28528
2014-08-07,19,Thursday,August,2014,False,19,28547
2014-08-08,11,Friday,August,2014,False,11,28558
2014-08-09,1,Saturday,August,2014,True,1,28559
2014-08-10,0,Sunday,August,2014,True,0,28559
2014-08-11,23,Monday,August,2014,False,23,28582
2014-08-12,24,Tuesday,August,2014,False,24,28606
2014-08-13,27,Wednesday,August,2014,False,27,28633
2014-08-14,9,Thursday,August,2014,False,9,28642
2014-08-15,4,Friday,August,2014,False,4,28646
2014-08-16,0,Saturday,August,2014,True,0,28646
2014-08-17,2,Sunday,August,2014,True,2,28648
2014-08-18,27,Monday,August,2014,False,27,28675
2014-08-19,26,Tuesday,August,2014,False,26,28701
2014-08-20,17,Wednesday,August,2014,False,17,28718
2014-08-21,24,Thursday,August,2014,False,24,28742
2014-08-22,12,Friday,August,2014,False,12,28754
2014-08-23,3,Saturday,August,2014,True,3,28757
2014-08-24,3,Sunday,August,2014,True,3,28760
2014-08-25,13,Monday,August,2014,False,13,28773
2014-08-26,19,Tuesday,August,2014,False,19,28792
2014-08-27,22,Wednesday,August,2014,False,22,28814
2014-08-28,9,Thursday,August,2014,False,9,28823
2014-08-29,13,Friday,August,2014,False,13,28836
2014-08-30,2,Saturday,August,2014,True,2,28838
2014-08-31,0,Sunday,August,2014,True,0,28838
2014-09-01,22,Monday,September,2014,False,22,28860
2014-09-02,17,Tuesday,September,2014,False,17,28877
2014-09-03,15,Wednesday,September,2014,False,15,28892
2014-09-04,23,Thursday,September,2014,False,23,28915
2014-09-05,7,Friday,September,2014,False,7,28922
2014-09-06,1,Saturday,September,2014,True,1,28923
2014-09-07,1,Sunday,September,2014,True,1,28924
2014-09-08,17,Monday,September,2014,False,17,28941
2014-09-09,17,Tuesday,September,2014,False,17,28958
2014-09-10,27,Wednesday,September,2014,False,27,28985
2014-09-11,15,Thursday,September,2014,False,15,29000
2014-09-12,10,Friday,September,2014,False,10,29010
2014-09-13,1,Saturday,September,2014,True,1,29011
2014-09-14,4,Sunday,September,2014,True,4,29015
2014-09-15,23,Monday,September,2014,False,23,29038
2014-09-16,27,Tuesday,September,2014,False,27,29065
2014-09-17,22,Wednesday,September,2014,False,22,29087
2014-09-18,15,Thursday,September,2014,False,15,29102
2014-09-19,9,Friday,September,2014,False,9,29111
2014-09-20,2,Saturday,September,2014,True,2,29113
2014-09-21,3,Sunday,September,2014,True,3,29116
2014-09-22,21,Monday,September,2014,False,21,29137
2014-09-23,25,Tuesday,September,2014,False,25,29162
2014-09-24,16,Wednesday,September,2014,False,16,29178
2014-09-25,10,Thursday,September,2014,False,10,29188
2014-09-26,6,Friday,September,2014,False,6,29194
2014-09-27,4,Saturday,September,2014,True,4,29198
2014-09-28,0,Sunday,September,2014,True,0,29198
2014-09-29,24,Monday,September,2014,False,24,29222
2014-09-30,26,Tuesday,September,2014,False,26,29248
2014-10-01,6,Wednesday,October,2014,False,6,29254
2014-10-02,18,Thursday,October,2014,False,18,29272
2014-10-03,9,Friday,October,2014,False,9,29281
2014-10-04,1,Saturday,October,2014,True,1,29282
2014-10-05,0,Sunday,October,2014,True,0,29282
2014-10-06,9,Monday,October,2014,False,9,29291
2014-10-07,11,Tuesday,October,2014,False,11,29302
2014-10-08,19,Wednesday,October,2014,False,19,29321
2014-10-09,15,Thursday,October,2014,False,15,29336
2014-10-10,8,Friday,October,2014,False,8,29344
2014-10-11,3,Saturday,October,2014,True,3,29347
2014-10-12,2,Sunday,October,2014,True,2,29349
2014-10-13,22,Monday,October,2014,False,22,29371
2014-10-14,34,Tuesday,October,2014,False,34,29405
2014-10-15,24,Wednesday,October,2014,False,24,29429
2014-10-16,19,Thursday,October,2014,False,19,29448
2014-10-17,8,Friday,October,2014,False,8,29456
2014-10-18,0,Saturday,October,2014,True,0,29456
2014-10-19,1,Sunday,October,2014,True,1,29457
2014-10-20,18,Monday,October,2014,False,18,29475
2014-10-21,31,Tuesday,October,2014,False,31,29506
2014-10-22,6,Wednesday,October,2014,False,6,29512
2014-10-23,22,Thursday,October,2014,False,22,29534
2014-10-24,5,Friday,October,2014,False,5,29539
2014-10-25,0,Saturday,October,2014,True,0,29539
2014-10-26,0,Sunday,October,2014,True,0,29539
2014-10-27,15,Monday,October,2014,False,15,29554
2014-10-28,19,Tuesday,October,2014,False,19,29573
2014-10-29,11,Wednesday,October,2014,False,11,29584
2014-10-30,18,Thursday,October,2014,False,18,29602
2014-10-31,6,Friday,October,2014,False,6,29608
2014-11-01,2,Saturday,November,2014,True,2,29610
2014-11-02,0,Sunday,November,2014,True,0,29610
2014-11-03,17,Monday,November,2014,False,17,29627
2014-11-04,12,Tuesday,November,2014,False,12,29639
2014-11-05,12,Wednesday,November,2014,False,12,29651
2014-11-06,27,Thursday,November,2014,False,27,29678
2014-11-07,15,Friday,November,2014,False,15,29693
2014-11-08,0,Saturday,November,2014,True,0,29693
2014-11-09,1,Sunday,November,2014,True,1,29694
2014-11-10,19,Monday,November,2014,False,19,29713
2014-11-11,25,Tuesday,November,2014,False,25,29738
2014-11-12,22,Wednesday,November,2014,False,22,29760
2014-11-13,6,Thursday,November,2014,False,6,29766
2014-11-14,6,Friday,November,2014,False,6,29772
2014-11-15,0,Saturday,November,2014,True,0,29772
2014-11-16,1,Sunday,November,2014,True,1,29773
2014-11-17,4,Monday,November,2014,False,4,29777
2014-11-18,11,Tuesday,November,2014,False,11,29788
2014-11-19,7,Wednesday,November,2014,False,7,29795
2014-11-20,6,Thursday,November,2014,False,6,29801
2014-11-21,2,Friday,November,2014,False,2,29803
2014-11-22,0,Saturday,November,2014,True,0,29803
2014-11-23,1,Sunday,November,2014,True,1,29804
2014-11-24,8,Monday,November,2014,False,8,29812
2014-11-25,11,Tuesday,November,2014,False,11,29823
2014-11-26,4,Wednesday,November,2014,False,4,29827
2014-11-27,11,Thursday,November,2014,False,11,29838
2014-11-28,6,Friday,November,2014,False,6,29844
2014-11-29,0,Saturday,November,2014,True,0,29844
2014-11-30,0,Sunday,November,2014,True,0,29844
2014-12-01,9,Monday,December,2014,False,9,29853
2014-12-02,24,Tuesday,December,2014,False,24,29877
2014-12-03,14,Wednesday,December,2014,False,14,29891
2014-12-04,13,Thursday,December,2014,False,13,29904
2014-12-05,2,Friday,December,2014,False,2,29906
2014-12-06,2,Saturday,December,2014,True,2,29908
2014-12-07,0,Sunday,December,2014,True,0,29908
2014-12-08,9,Monday,December,2014,False,9,29917
2014-12-09,13,Tuesday,December,2014,False,13,29930
2014-12-10,8,Wednesday,December,2014,False,8,29938
2014-12-11,14,Thursday,December,2014,False,14,29952
2014-12-12,8,Friday,December,2014,False,8,29960
2014-12-13,0,Saturday,December,2014,True,0,29960
2014-12-14,0,Sunday,December,2014,True,0,29960
2014-12-15,17,Monday,December,2014,False,17,29977
2014-12-16,13,Tuesday,December,2014,False,13,29990
2014-12-17,8,Wednesday,December,2014,False,8,29998
2014-12-18,13,Thursday,December,2014,False,13,30011
2014-12-19,4,Friday,December,2014,False,4,30015
2014-12-20,1,Saturday,December,2014,True,1,30016
2014-12-21,0,Sunday,December,2014,True,0,30016
2014-12-22,3,Monday,December,2014,False,3,30019
2014-12-23,6,Tuesday,December,2014,False,6,30025
2014-12-24,4,Wednesday,December,2014,False,4,30029
2014-12-25,0,Thursday,December,2014,False,0,30029
2014-12-26,1,Friday,December,2014,False,1,30030
2014-12-27,0,Saturday,December,2014,True,0,30030
2014-12-28,0,Sunday,December,2014,True,0,30030
2014-12-29,3,Monday,December,2014,False,3,30033
2014-12-30,1,Tuesday,December,2014,False,1,30034
2014-12-31,5,Wednesday,December,2014,False,5,30039
2015-01-01,14,Thursday,January,2015,False,14,30053
2015-01-02,5,Friday,January,2015,False,5,30058
2015-01-03,2,Saturday,January,2015,True,2,30060
2015-01-04,0,Sunday,January,2015,True,0,30060
2015-01-05,15,Monday,January,2015,False,15,30075
2015-01-06,18,Tuesday,January,2015,False,18,30093
2015-01-07,17,Wednesday,January,2015,False,17,30110
2015-01-08,14,Thursday,January,2015,False,14,30124
2015-01-09,9,Friday,January,2015,False,9,30133
2015-01-10,0,Saturday,January,2015,True,0,30133
2015-01-11,1,Sunday,January,2015,True,1,30134
2015-01-12,19,Monday,January,2015,False,19,30153
2015-01-13,19,Tuesday,January,2015,False,19,30172
2015-01-14,17,Wednesday,January,2015,False,17,30189
2015-01-15,18,Thursday,January,2015,False,18,30207
2015-01-16,12,Friday,January,2015,False,12,30219
2015-01-17,0,Saturday,January,2015,True,0,30219
2015-01-18,0,Sunday,January,2015,True,0,30219
2015-01-19,20,Monday,January,2015,False,20,30239
2015-01-20,30,Tuesday,January,2015,False,30,30269
2015-01-21,13,Wednesday,January,2015,False,13,30282
2015-01-22,16,Thursday,January,2015,False,16,30298
2015-01-23,11,Friday,January,2015,False,11,30309
2015-01-24,3,Saturday,January,2015,True,3,30312
2015-01-25,0,Sunday,January,2015,True,0,30312
2015-01-26,26,Monday,January,2015,False,26,30338
2015-01-27,24,Tuesday,January,2015,False,24,30362
2015-01-28,20,Wednesday,January,2015,False,20,30382
2015-01-29,24,Thursday,January,2015,False,24,30406
2015-01-30,22,Friday,January,2015,False,22,30428
2015-01-31,2,Saturday,January,2015,True,2,30430
2015-02-01,0,Sunday,February,2015,True,0,30430
2015-02-02,25,Monday,February,2015,False,25,30455
2015-02-03,20,Tuesday,February,2015,False,20,30475
2015-02-04,17,Wednesday,February,2015,False,17,30492
2015-02-05,29,Thursday,February,2015,False,29,30521
2015-02-06,12,Friday,February,2015,False,12,30533
2015-02-07,0,Saturday,February,2015,True,0,30533
2015-02-08,1,Sunday,February,2015,True,1,30534
2015-02-09,22,Monday,February,2015,False,22,30556
2015-02-10,22,Tuesday,February,2015,False,22,30578
2015-02-11,16,Wednesday,February,2015,False,16,30594
2015-02-12,23,Thursday,February,2015,False,23,30617
2015-02-13,12,Friday,February,2015,False,12,30629
2015-02-14,1,Saturday,February,2015,True,1,30630
2015-02-15,1,Sunday,February,2015,True,1,30631
2015-02-16,29,Monday,February,2015,False,29,30660
2015-02-17,19,Tuesday,February,2015,False,19,30679
2015-02-18,19,Wednesday,February,2015,False,19,30698
2015-02-19,12,Thursday,February,2015,False,12,30710
2015-02-20,7,Friday,February,2015,False,7,30717
2015-02-21,1,Saturday,February,2015,True,1,30718
2015-02-22,,Sunday,February,2015,True,0,30718
2015-02-23,33,Monday,February,2015,False,33,30751
2015-02-24,20,Tuesday,February,2015,False,20,30771
2015-02-25,24,Wednesday,February,2015,False,24,30795
2015-02-26,14,Thursday,February,2015,False,14,30809
2015-02-27,14,Friday,February,2015,False,14,30823
2015-02-28,,Saturday,February,2015,True,0,30823
2015-03-01,1,Sunday,March,2015,True,1,30824
2015-03-02,15,Monday,March,2015,False,15,30839
2015-03-03,20,Tuesday,March,2015,False,20,30859
2015-03-04,18,Wednesday,March,2015,False,18,30877
2015-03-05,19,Thursday,March,2015,False,19,30896
2015-03-06,17,Friday,March,2015,False,17,30913
2015-03-07,0,Saturday,March,2015,True,0,30913
2015-03-08,3,Sunday,March,2015,True,3,30916
2015-03-09,20,Monday,March,2015,False,20,30936
2015-03-10,29,Tuesday,March,2015,False,29,30965
2015-03-11,17,Wednesday,March,2015,False,17,30982
2015-03-12,16,Thursday,March,2015,False,16,30998
2015-03-13,15,Friday,March,2015,False,15,31013
2015-03-14,2,Saturday,March,2015,True,2,31015
2015-03-15,4,Sunday,March,2015,True,4,31019
2015-03-16,18,Monday,March,2015,False,18,31037
2015-03-17,30,Tuesday,March,2015,False,30,31067
2015-03-18,14,Wednesday,March,2015,False,14,31081
2015-03-19,15,Thursday,March,2015,False,15,31096
2015-03-20,6,Friday,March,2015,False,6,31102
2015-03-21,2,Saturday,March,2015,True,2,31104
2015-03-22,4,Sunday,March,2015,True,4,31108
2015-03-23,21,Monday,March,2015,False,21,31129
2015-03-24,28,Tuesday,March,2015,False,28,31157
2015-03-25,11,Wednesday,March,2015,False,11,31168
2015-03-26,17,Thursday,March,2015,False,17,31185
2015-03-27,6,Friday,March,2015,False,6,31191
2015-03-28,1,Saturday,March,2015,True,1,31192
2015-03-29,,Sunday,March,2015,True,0,31192
2015-03-30,19,Monday,March,2015,False,19,31211
2015-03-31,24,Tuesday,March,2015,False,24,31235
2015-04-01,17,Wednesday,April,2015,False,17,31252
2015-04-02,16,Thursday,April,2015,False,16,31268
2015-04-03,3,Friday,April,2015,False,3,31271
2015-04-04,1,Saturday,April,2015,True,1,31272
2015-04-05,0,Sunday,April,2015,True,0,31272
2015-04-06,1,Monday,April,2015,False,1,31273
2015-04-07,29,Tuesday,April,2015,False,29,31302
2015-04-08,21,Wednesday,April,2015,False,21,31323
2015-04-09,12,Thursday,April,2015,False,12,31335
2015-04-10,10,Friday,April,2015,False,10,31345
2015-04-11,3,Saturday,April,2015,True,3,31348
2015-04-12,4,Sunday,April,2015,True,4,31352
2015-04-13,24,Monday,April,2015,False,24,31376
2015-04-14,29,Tuesday,April,2015,False,29,31405
2015-04-15,24,Wednesday,April,2015,False,24,31429
2015-04-16,29,Thursday,April,2015,False,29,31458
2015-04-17,6,Friday,April,2015,False,6,31464
2015-04-18,1,Saturday,April,2015,True,1,31465
2015-04-19,2,Sunday,April,2015,True,2,31467
2015-04-20,25,Monday,April,2015,False,25,31492
2015-04-21,27,Tuesday,April,2015,False,27,31519
2015-04-22,15,Wednesday,April,2015,False,15,31534
2015-04-23,21,Thursday,April,2015,False,21,31555
2015-04-24,11,Friday,April,2015,False,11,31566
2015-04-25,4,Saturday,April,2015,True,4,31570
2015-04-26,3,Sunday,April,2015,True,3,31573
2015-04-27,26,Monday,April,2015,False,26,31599
2015-04-28,49,Tuesday,April,2015,False,49,31648
2015-04-29,14,Wednesday,April,2015,False,14,31662
2015-04-30,12,Thursday,April,2015,False,12,31674
2015-05-01,3,Friday,May,2015,False,3,31677
2015-05-02,7,Saturday,May,2015,True,7,31684
2015-05-03,1,Sunday,May,2015,True,1,31685
2015-05-04,20,Monday,May,2015,False,20,31705
2015-05-05,30,Tuesday,May,2015,False,30,31735
2015-05-06,18,Wednesday,May,2015,False,18,31753
2015-05-07,18,Thursday,May,2015,False,18,31771
2015-05-08,4,Friday,May,2015,False,4,31775
2015-05-09,3,Saturday,May,2015,True,3,31778
2015-05-10,2,Sunday,May,2015,True,2,31780
2015-05-11,18,Monday,May,2015,False,18,31798
2015-05-12,25,Tuesday,May,2015,False,25,31823
2015-05-13,17,Wednesday,May,2015,False,17,31840
2015-05-14,10,Thursday,May,2015,False,10,31850
2015-05-15,9,Friday,May,2015,False,9,31859
2015-05-16,0,Saturday,May,2015,True,0,31859
2015-05-17,2,Sunday,May,2015,True,2,31861
2015-05-18,24,Monday,May,2015,False,24,31885
2015-05-19,20,Tuesday,May,2015,False,20,31905
2015-05-20,20,Wednesday,May,2015,False,20,31925
2015-05-21,16,Thursday,May,2015,False,16,31941
2015-05-22,9,Friday,May,2015,False,9,31950
2015-05-23,2,Saturday,May,2015,True,2,31952
2015-05-24,0,Sunday,May,2015,True,0,31952
2015-05-25,16,Monday,May,2015,False,16,31968
2015-05-26,21,Tuesday,May,2015,False,21,31989
2015-05-27,11,Wednesday,May,2015,False,11,32000
2015-05-28,15,Thursday,May,2015,False,15,32015
2015-05-29,5,Friday,May,2015,False,5,32020
2015-05-30,3,Saturday,May,2015,True,3,32023
2015-05-31,1,Sunday,May,2015,True,1,32024
2015-06-01,21,Monday,June,2015,False,21,32045
2015-06-02,26,Tuesday,June,2015,False,26,32071
2015-06-03,15,Wednesday,June,2015,False,15,32086
2015-06-04,16,Thursday,June,2015,False,16,32102
2015-06-05,5,Friday,June,2015,False,5,32107
2015-06-06,1,Saturday,June,2015,True,1,32108
2015-06-07,6,Sunday,June,2015,True,6,32114
2015-06-08,21,Monday,June,2015,False,21,32135
2015-06-09,21,Tuesday,June,2015,False,21,32156
2015-06-10,15,Wednesday,June,2015,False,15,32171
2015-06-11,21,Thursday,June,2015,False,21,32192
2015-06-12,10,Friday,June,2015,False,10,32202
2015-06-13,0,Saturday,June,2015,True,0,32202
2015-06-14,0,Sunday,June,2015,True,0,32202
2015-06-15,25,Monday,June,2015,False,25,32227
2015-06-16,33,Tuesday,June,2015,False,33,32260
2015-06-17,17,Wednesday,June,2015,False,17,32277
2015-06-18,18,Thursday,June,2015,False,18,32295
2015-06-19,8,Friday,June,2015,False,8,32303
2015-06-20,4,Saturday,June,2015,True,4,32307
2015-06-21,3,Sunday,June,2015,True,3,32310
2015-06-22,28,Monday,June,2015,False,28,32338
2015-06-23,20,Tuesday,June,2015,False,20,32358
2015-06-24,13,Wednesday,June,2015,False,13,32371
2015-06-25,19,Thursday,June,2015,False,19,32390
2015-06-26,5,Friday,June,2015,False,5,32395
2015-06-27,2,Saturday,June,2015,True,2,32397
2015-06-28,1,Sunday,June,2015,True,1,32398
2015-06-29,28,Monday,June,2015,False,28,32426
2015-06-30,27,Tuesday,June,2015,False,27,32453
2015-07-01,9,Wednesday,July,2015,False,9,32462
2015-07-02,14,Thursday,July,2015,False,14,32476
2015-07-03,4,Friday,July,2015,False,4,32480
2015-07-04,4,Saturday,July,2015,True,4,32484
2015-07-05,4,Sunday,July,2015,True,4,32488
2015-07-06,17,Monday,July,2015,False,17,32505
2015-07-07,22,Tuesday,July,2015,False,22,32527
2015-07-08,11,Wednesday,July,2015,False,11,32538
2015-07-09,15,Thursday,July,2015,False,15,32553
2015-07-10,8,Friday,July,2015,False,8,32561
2015-07-11,0,Saturday,July,2015,True,0,32561
2015-07-12,1,Sunday,July,2015,True,1,32562
2015-07-13,24,Monday,July,2015,False,24,32586
2015-07-14,17,Tuesday,July,2015,False,17,32603
2015-07-15,13,Wednesday,July,2015,False,13,32616
2015-07-16,9,Thursday,July,2015,False,9,32625
2015-07-17,13,Friday,July,2015,False,13,32638
2015-07-18,1,Saturday,July,2015,True,1,32639
2015-07-19,2,Sunday,July,2015,True,2,32641
2015-07-20,7,Monday,July,2015,False,7,32648
2015-07-21,25,Tuesday,July,2015,False,25,32673
2015-07-22,14,Wednesday,July,2015,False,14,32687
2015-07-23,16,Thursday,July,2015,False,16,32703
2015-07-24,3,Friday,July,2015,False,3,32706
2015-07-25,2,Saturday,July,2015,True,2,32708
2015-07-26,2,Sunday,July,2015,True,2,32710
2015-07-27,27,Monday,July,2015,False,27,32737
2015-07-28,24,Tuesday,July,2015,False,24,32761
2015-07-29,16,Wednesday,July,2015,False,16,32777
2015-07-30,23,Thursday,July,2015,False,23,32800
2015-07-31,6,Friday,July,2015,False,6,32806
2015-08-01,1,Saturday,August,2015,True,1,32807
2015-08-02,0,Sunday,August,2015,True,0,32807
2015-08-03,20,Monday,August,2015,False,20,32827
2015-08-04,32,Tuesday,August,2015,False,32,32859
2015-08-05,14,Wednesday,August,2015,False,14,32873
2015-08-06,14,Thursday,August,2015,False,14,32887
2015-08-07,9,Friday,August,2015,False,9,32896
2015-08-08,1,Saturday,August,2015,True,1,32897
2015-08-09,5,Sunday,August,2015,True,5,32902
2015-08-10,22,Monday,August,2015,False,22,32924
2015-08-11,16,Tuesday,August,2015,False,16,32940
2015-08-12,14,Wednesday,August,2015,False,14,32954
2015-08-13,21,Thursday,August,2015,False,21,32975
2015-08-14,10,Friday,August,2015,False,10,32985
2015-08-15,2,Saturday,August,2015,True,2,32987
2015-08-16,1,Sunday,August,2015,True,1,32988
2015-08-17,31,Monday,August,2015,False,31,33019
2015-08-18,26,Tuesday,August,2015,False,26,33045
2015-08-19,19,Wednesday,August,2015,False,19,33064
2015-08-20,16,Thursday,August,2015,False,16,33080
2015-08-21,3,Friday,August,2015,False,3,33083
2015-08-22,1,Saturday,August,2015,True,1,33084
2015-08-23,,Sunday,August,2015,True,0,33084
2015-08-24,16,Monday,August,2015,False,16,33100
2015-08-25,25,Tuesday,August,2015,False,25,33125
2015-08-26,25,Wednesday,August,2015,False,25,33150
2015-08-27,19,Thursday,August,2015,False,19,33169
2015-08-28,17,Friday,August,2015,False,17,33186
2015-08-29,1,Saturday,August,2015,True,1,33187
2015-08-30,2,Sunday,August,2015,True,2,33189
2015-08-31,11,Monday,August,2015,False,11,33200
2015-09-01,30,Tuesday,September,2015,False,30,33230
2015-09-02,19,Wednesday,September,2015,False,19,33249
2015-09-03,22,Thursday,September,2015,False,22,33271
2015-09-04,6,Friday,September,2015,False,6,33277
2015-09-05,1,Saturday,September,2015,True,1,33278
2015-09-06,5,Sunday,September,2015,True,5,33283
2015-09-07,22,Monday,September,2015,False,22,33305
2015-09-08,31,Tuesday,September,2015,False,31,33336
2015-09-09,16,Wednesday,September,2015,False,16,33352
2015-09-10,28,Thursday,September,2015,False,28,33380
2015-09-11,9,Friday,September,2015,False,9,33389
2015-09-12,1,Saturday,September,2015,True,1,33390
2015-09-13,1,Sunday,September,2015,True,1,33391
2015-09-14,21,Monday,September,2015,False,21,33412
2015-09-15,21,Tuesday,September,2015,False,21,33433
2015-09-16,18,Wednesday,September,2015,False,18,33451
2015-09-17,13,Thursday,September,2015,False,13,33464
2015-09-18,6,Friday,September,2015,False,6,33470
2015-09-19,3,Saturday,September,2015,True,3,33473
2015-09-20,2,Sunday,September,2015,True,2,33475
2015-09-21,20,Monday,September,2015,False,20,33495
2015-09-22,23,Tuesday,September,2015,False,23,33518
2015-09-23,23,Wednesday,September,2015,False,23,33541
2015-09-24,6,Thursday,September,2015,False,6,33547
2015-09-25,5,Friday,September,2015,False,5,33552
2015-09-26,1,Saturday,September,2015,True,1,33553
2015-09-27,5,Sunday,September,2015,True,5,33558
2015-09-28,22,Monday,September,2015,False,22,33580
2015-09-29,20,Tuesday,September,2015,False,20,33600
2015-09-30,24,Wednesday,September,2015,False,24,33624
2015-10-01,1,Thursday,October,2015,False,1,33625
2015-10-02,16,Friday,October,2015,False,16,33641
2015-10-03,3,Saturday,October,2015,True,3,33644
2015-10-04,0,Sunday,October,2015,True,0,33644
2015-10-05,19,Monday,October,2015,False,19,33663
2015-10-06,18,Tuesday,October,2015,False,18,33681
2015-10-07,20,Wednesday,October,2015,False,20,33701
2015-10-08,25,Thursday,October,2015,False,25,33726
2015-10-09,10,Friday,October,2015,False,10,33736
2015-10-10,4,Saturday,October,2015,True,4,33740
2015-10-11,0,Sunday,October,2015,True,0,33740
2015-10-12,34,Monday,October,2015,False,34,33774
2015-10-13,19,Tuesday,October,2015,False,19,33793
2015-10-14,14,Wednesday,October,2015,False,14,33807
2015-10-15,25,Thursday,October,2015,False,25,33832
2015-10-16,11,Friday,October,2015,False,11,33843
2015-10-17,3,Saturday,October,2015,True,3,33846
2015-10-18,3,Sunday,October,2015,True,3,33849
2015-10-19,20,Monday,October,2015,False,20,33869
2015-10-20,29,Tuesday,October,2015,False,29,33898
2015-10-21,14,Wednesday,October,2015,False,14,33912
2015-10-22,23,Thursday,October,2015,False,23,33935
2015-10-23,5,Friday,October,2015,False,5,33940
2015-10-24,,Saturday,October,2015,True,0,33940
2015-10-25,2,Sunday,October,2015,True,2,33942
2015-10-26,25,Monday,October,2015,False,25,33967
2015-10-27,12,Tuesday,October,2015,False,12,33979
2015-10-28,14,Wednesday,October,2015,False,14,33993
2015-10-29,31,Thursday,October,2015,False,31,34024
2015-10-30,6,Friday,October,2015,False,6,34030
2015-10-31,,Saturday,October,2015,True,0,34030
2015-11-01,1,Sunday,November,2015,True,1,34031
2015-11-02,30,Monday,November,2015,False,30,34061
2015-11-03,32,Tuesday,November,2015,False,32,34093
2015-11-04,19,Wednesday,November,2015,False,19,34112
2015-11-05,23,Thursday,November,2015,False,23,34135
2015-11-06,10,Friday,November,2015,False,10,34145
2015-11-07,1,Saturday,November,2015,True,1,34146
2015-11-08,,Sunday,November,2015,True,0,34146
2015-11-09,15,Monday,November,2015,False,15,34161
2015-11-10,17,Tuesday,November,2015,False,17,34178
2015-11-11,21,Wednesday,November,2015,False,21,34199
2015-11-12,17,Thursday,November,2015,False,17,34216
2015-11-13,7,Friday,November,2015,False,7,34223
2015-11-14,,Saturday,November,2015,True,0,34223
2015-11-15,1,Sunday,November,2015,True,1,34224
2015-11-16,21,Monday,November,2015,False,21,34245
2015-11-17,25,Tuesday,November,2015,False,25,34270
2015-11-18,15,Wednesday,November,2015,False,15,34285
2015-11-19,14,Thursday,November,2015,False,14,34299
2015-11-20,15,Friday,November,2015,False,15,34314
2015-11-21,,Saturday,November,2015,True,0,34314
2015-11-22,1,Sunday,November,2015,True,1,34315
2015-11-23,17,Monday,November,2015,False,17,34332
2015-11-24,20,Tuesday,November,2015,False,20,34352
2015-11-25,16,Wednesday,November,2015,False,16,34368
2015-11-26,11,Thursday,November,2015,False,11,34379
2015-11-27,12,Friday,November,2015,False,12,34391
2015-11-28,1,Saturday,November,2015,True,1,34392
2015-11-29,,Sunday,November,2015,True,0,34392
2015-11-30,16,Monday,November,2015,False,16,34408
2015-12-01,17,Tuesday,December,2015,False,17,34425
2015-12-02,10,Wednesday,December,2015,False,10,34435
2015-12-03,10,Thursday,December,2015,False,10,34445
2015-12-04,14,Friday,December,2015,False,14,34459
2015-12-05,2,Saturday,December,2015,True,2,34461
2015-12-06,,Sunday,December,2015,True,0,34461
2015-12-07,27,Monday,December,2015,False,27,34488
2015-12-08,25,Tuesday,December,2015,False,25,34513
2015-12-09,13,Wednesday,December,2015,False,13,34526
2015-12-10,22,Thursday,December,2015,False,22,34548
2015-12-11,8,Friday,December,2015,False,8,34556
2015-12-12,1,Saturday,December,2015,True,1,34557
2015-12-13,0,Sunday,December,2015,True,0,34557
2015-12-14,11,Monday,December,2015,False,11,34568
2015-12-15,23,Tuesday,December,2015,False,23,34591
2015-12-16,11,Wednesday,December,2015,False,11,34602
2015-12-17,22,Thursday,December,2015,False,22,34624
2015-12-18,8,Friday,December,2015,False,8,34632
2015-12-19,2,Saturday,December,2015,True,2,34634
2015-12-20,1,Sunday,December,2015,True,1,34635
2015-12-21,13,Monday,December,2015,False,13,34648
2015-12-22,19,Tuesday,December,2015,False,19,34667
2015-12-23,9,Wednesday,December,2015,False,9,34676
2015-12-24,3,Thursday,December,2015,False,3,34679
2015-12-25,1,Friday,December,2015,False,1,34680
2015-12-26,0,Saturday,December,2015,True,0,34680
2015-12-27,0,Sunday,December,2015,True,0,34680
2015-12-28,3,Monday,December,2015,False,3,34683
2015-12-29,10,Tuesday,December,2015,False,10,34693
2015-12-30,2,Wednesday,December,2015,False,2,34695
2015-12-31,4,Thursday,December,2015,False,4,34699
2016-01-01,3,Friday,January,2016,False,3,34702
2016-01-02,2,Saturday,January,2016,True,2,34704
2016-01-03,,Sunday,January,2016,True,0,34704
2016-01-04,11,Monday,January,2016,False,11,34715
2016-01-05,19,Tuesday,January,2016,False,19,34734
2016-01-06,21,Wednesday,January,2016,False,21,34755
2016-01-07,23,Thursday,January,2016,False,23,34778
2016-01-08,17,Friday,January,2016,False,17,34795
2016-01-09,0,Saturday,January,2016,True,0,34795
2016-01-10,1,Sunday,January,2016,True,1,34796
2016-01-11,44,Monday,January,2016,False,44,34840
2016-01-12,35,Tuesday,January,2016,False,35,34875
2016-01-13,16,Wednesday,January,2016,False,16,34891
2016-01-14,31,Thursday,January,2016,False,31,34922
2016-01-15,11,Friday,January,2016,False,11,34933
2016-01-16,3,Saturday,January,2016,True,3,34936
2016-01-17,1,Sunday,January,2016,True,1,34937
2016-01-18,30,Monday,January,2016,False,30,34967
2016-01-19,32,Tuesday,January,2016,False,32,34999
2016-01-20,21,Wednesday,January,2016,False,21,35020
2016-01-21,22,Thursday,January,2016,False,22,35042
2016-01-22,17,Friday,January,2016,False,17,35059
2016-01-23,1,Saturday,January,2016,True,1,35060
2016-01-24,0,Sunday,January,2016,True,0,35060
2016-01-25,26,Monday,January,2016,False,26,35086
2016-01-26,23,Tuesday,January,2016,False,23,35109
2016-01-27,20,Wednesday,January,2016,False,20,35129
2016-01-28,18,Thursday,January,2016,False,18,35147
2016-01-29,5,Friday,January,2016,False,5,35152
2016-01-30,0,Saturday,January,2016,True,0,35152
2016-01-31,,Sunday,January,2016,True,0,35152
2016-02-01,17,Monday,February,2016,False,17,35169
2016-02-02,31,Tuesday,February,2016,False,31,35200
2016-02-03,15,Wednesday,February,2016,False,15,35215
2016-02-04,17,Thursday,February,2016,False,17,35232
2016-02-05,4,Friday,February,2016,False,4,35236
2016-02-06,5,Saturday,February,2016,True,5,35241
2016-02-07,1,Sunday,February,2016,True,1,35242
2016-02-08,20,Monday,February,2016,False,20,35262
2016-02-09,28,Tuesday,February,2016,False,28,35290
2016-02-10,24,Wednesday,February,2016,False,24,35314
2016-02-11,15,Thursday,February,2016,False,15,35329
2016-02-12,14,Friday,February,2016,False,14,35343
2016-02-13,1,Saturday,February,2016,True,1,35344
2016-02-14,2,Sunday,February,2016,True,2,35346
2016-02-15,19,Monday,February,2016,False,19,35365
2016-02-16,29,Tuesday,February,2016,False,29,35394
2016-02-17,10,Wednesday,February,2016,False,10,35404
2016-02-18,27,Thursday,February,2016,False,27,35431
2016-02-19,10,Friday,February,2016,False,10,35441
2016-02-20,4,Saturday,February,2016,True,4,35445
2016-02-21,0,Sunday,February,2016,True,0,35445
2016-02-22,17,Monday,February,2016,False,17,35462
2016-02-23,34,Tuesday,February,2016,False,34,35496
2016-02-24,21,Wednesday,February,2016,False,21,35517
2016-02-25,19,Thursday,February,2016,False,19,35536
2016-02-26,13,Friday,February,2016,False,13,35549
2016-02-27,0,Saturday,February,2016,True,0,35549
2016-02-28,2,Sunday,February,2016,True,2,35551
2016-02-29,22,Monday,February,2016,False,22,35573
2016-03-01,19,Tuesday,March,2016,False,19,35592
2016-03-02,14,Wednesday,March,2016,False,14,35606
2016-03-03,20,Thursday,March,2016,False,20,35626
2016-03-04,12,Friday,March,2016,False,12,35638
2016-03-05,1,Saturday,March,2016,True,1,35639
2016-03-06,0,Sunday,March,2016,True,0,35639
2016-03-07,23,Monday,March,2016,False,23,35662
2016-03-08,24,Tuesday,March,2016,False,24,35686
2016-03-09,12,Wednesday,March,2016,False,12,35698
2016-03-10,7,Thursday,March,2016,False,7,35705
2016-03-11,7,Friday,March,2016,False,7,35712
2016-03-12,0,Saturday,March,2016,True,0,35712
2016-03-13,2,Sunday,March,2016,True,2,35714
2016-03-14,17,Monday,March,2016,False,17,35731
2016-03-15,24,Tuesday,March,2016,False,24,35755
2016-03-16,17,Wednesday,March,2016,False,17,35772
2016-03-17,19,Thursday,March,2016,False,19,35791
2016-03-18,9,Friday,March,2016,False,9,35800
2016-03-19,0,Saturday,March,2016,True,0,35800
2016-03-20,0,Sunday,March,2016,True,0,35800
2016-03-21,22,Monday,March,2016,False,22,35822
2016-03-22,17,Tuesday,March,2016,False,17,35839
2016-03-23,25,Wednesday,March,2016,False,25,35864
2016-03-24,20,Thursday,March,2016,False,20,35884
2016-03-25,2,Friday,March,2016,False,2,35886
2016-03-26,0,Saturday,March,2016,True,0,35886
2016-03-27,1,Sunday,March,2016,True,1,35887
2016-03-28,5,Monday,March,2016,False,5,35892
2016-03-29,19,Tuesday,March,2016,False,19,35911
2016-03-30,25,Wednesday,March,2016,False,25,35936
2016-03-31,15,Thursday,March,2016,False,15,35951
2016-04-01,12,Friday,April,2016,False,12,35963
2016-04-02,3,Saturday,April,2016,True,3,35966
2016-04-03,4,Sunday,April,2016,True,4,35970
2016-04-04,21,Monday,April,2016,False,21,35991
2016-04-05,29,Tuesday,April,2016,False,29,36020
2016-04-06,21,Wednesday,April,2016,False,21,36041
2016-04-07,22,Thursday,April,2016,False,22,36063
2016-04-08,6,Friday,April,2016,False,6,36069
2016-04-09,3,Saturday,April,2016,True,3,36072
2016-04-10,2,Sunday,April,2016,True,2,36074
2016-04-11,21,Monday,April,2016,False,21,36095
2016-04-12,14,Tuesday,April,2016,False,14,36109
2016-04-13,20,Wednesday,April,2016,False,20,36129
2016-04-14,14,Thursday,April,2016,False,14,36143
2016-04-15,5,Friday,April,2016,False,5,36148
2016-04-16,0,Saturday,April,2016,True,0,36148
2016-04-17,2,Sunday,April,2016,True,2,36150
2016-04-18,18,Monday,April,2016,False,18,36168
2016-04-19,17,Tuesday,April,2016,False,17,36185
2016-04-20,18,Wednesday,April,2016,False,18,36203
2016-04-21,19,Thursday,April,2016,False,19,36222
2016-04-22,10,Friday,April,2016,False,10,36232
2016-04-23,3,Saturday,April,2016,True,3,36235
2016-04-24,4,Sunday,April,2016,True,4,36239
2016-04-25,13,Monday,April,2016,False,13,36252
2016-04-26,24,Tuesday,April,2016,False,24,36276
2016-04-27,19,Wednesday,April,2016,False,19,36295
2016-04-28,19,Thursday,April,2016,False,19,36314
2016-04-29,7,Friday,April,2016,False,7,36321
2016-04-30,0,Saturday,April,2016,True,0,36321
2016-05-01,1,Sunday,May,2016,True,1,36322
2016-05-02,5,Monday,May,2016,False,5,36327
2016-05-03,19,Tuesday,May,2016,False,19,36346
2016-05-04,17,Wednesday,May,2016,False,17,36363
2016-05-05,14,Thursday,May,2016,False,14,36377
2016-05-06,12,Friday,May,2016,False,12,36389
2016-05-07,4,Saturday,May,2016,True,4,36393
2016-05-08,5,Sunday,May,2016,True,5,36398
2016-05-09,21,Monday,May,2016,False,21,36419
2016-05-10,23,Tuesday,May,2016,False,23,36442
2016-05-11,19,Wednesday,May,2016,False,19,36461
2016-05-12,30,Thursday,May,2016,False,30,36491
2016-05-13,6,Friday,May,2016,False,6,36497
2016-05-14,1,Saturday,May,2016,True,1,36498
2016-05-15,4,Sunday,May,2016,True,4,36502
2016-05-16,21,Monday,May,2016,False,21,36523
2016-05-17,24,Tuesday,May,2016,False,24,36547
2016-05-18,11,Wednesday,May,2016,False,11,36558
2016-05-19,15,Thursday,May,2016,False,15,36573
2016-05-20,8,Friday,May,2016,False,8,36581
2016-05-21,0,Saturday,May,2016,True,0,36581
2016-05-22,3,Sunday,May,2016,True,3,36584
2016-05-23,14,Monday,May,2016,False,14,36598
2016-05-24,29,Tuesday,May,2016,False,29,36627
2016-05-25,15,Wednesday,May,2016,False,15,36642
2016-05-26,8,Thursday,May,2016,False,8,36650
2016-05-27,10,Friday,May,2016,False,10,36660
2016-05-28,0,Saturday,May,2016,True,0,36660
2016-05-29,4,Sunday,May,2016,True,4,36664
2016-05-30,7,Monday,May,2016,False,7,36671
2016-05-31,22,Tuesday,May,2016,False,22,36693
2016-06-01,16,Wednesday,June,2016,False,16,36709
2016-06-02,28,Thursday,June,2016,False,28,36737
2016-06-03,6,Friday,June,2016,False,6,36743
2016-06-04,3,Saturday,June,2016,True,3,36746
2016-06-05,2,Sunday,June,2016,True,2,36748
2016-06-06,23,Monday,June,2016,False,23,36771
2016-06-07,29,Tuesday,June,2016,False,29,36800
2016-06-08,22,Wednesday,June,2016,False,22,36822
2016-06-09,17,Thursday,June,2016,False,17,36839
2016-06-10,13,Friday,June,2016,False,13,36852
2016-06-11,1,Saturday,June,2016,True,1,36853
2016-06-12,2,Sunday,June,2016,True,2,36855
2016-06-13,23,Monday,June,2016,False,23,36878
2016-06-14,22,Tuesday,June,2016,False,22,36900
2016-06-15,14,Wednesday,June,2016,False,14,36914
2016-06-16,12,Thursday,June,2016,False,12,36926
2016-06-17,6,Friday,June,2016,False,6,36932
2016-06-18,2,Saturday,June,2016,True,2,36934
2016-06-19,2,Sunday,June,2016,True,2,36936
2016-06-20,26,Monday,June,2016,False,26,36962
2016-06-21,13,Tuesday,June,2016,False,13,36975
2016-06-22,11,Wednesday,June,2016,False,11,36986
2016-06-23,12,Thursday,June,2016,False,12,36998
2016-06-24,12,Friday,June,2016,False,12,37010
2016-06-25,2,Saturday,June,2016,True,2,37012
2016-06-26,1,Sunday,June,2016,True,1,37013
2016-06-27,19,Monday,June,2016,False,19,37032
2016-06-28,23,Tuesday,June,2016,False,23,37055
2016-06-29,15,Wednesday,June,2016,False,15,37070
2016-06-30,17,Thursday,June,2016,False,17,37087
2016-07-01,10,Friday,July,2016,False,10,37097
2016-07-02,1,Saturday,July,2016,True,1,37098
2016-07-03,2,Sunday,July,2016,True,2,37100
2016-07-04,16,Monday,July,2016,False,16,37116
2016-07-05,10,Tuesday,July,2016,False,10,37126
2016-07-06,8,Wednesday,July,2016,False,8,37134
2016-07-07,6,Thursday,July,2016,False,6,37140
2016-07-08,14,Friday,July,2016,False,14,37154
2016-07-09,1,Saturday,July,2016,True,1,37155
2016-07-10,2,Sunday,July,2016,True,2,37157
2016-07-11,21,Monday,July,2016,False,21,37178
2016-07-12,21,Tuesday,July,2016,False,21,37199
2016-07-13,22,Wednesday,July,2016,False,22,37221
2016-07-14,23,Thursday,July,2016,False,23,37244
2016-07-15,7,Friday,July,2016,False,7,37251
2016-07-16,3,Saturday,July,2016,True,3,37254
2016-07-17,3,Sunday,July,2016,True,3,37257
2016-07-18,24,Monday,July,2016,False,24,37281
2016-07-19,19,Tuesday,July,2016,False,19,37300
2016-07-20,9,Wednesday,July,2016,False,9,37309
2016-07-21,24,Thursday,July,2016,False,24,37333
2016-07-22,7,Friday,July,2016,False,7,37340
2016-07-23,0,Saturday,July,2016,True,0,37340
2016-07-24,0,Sunday,July,2016,True,0,37340
2016-07-25,24,Monday,July,2016,False,24,37364
2016-07-26,16,Tuesday,July,2016,False,16,37380
2016-07-27,13,Wednesday,July,2016,False,13,37393
2016-07-28,12,Thursday,July,2016,False,12,37405
2016-07-29,12,Friday,July,2016,False,12,37417
2016-07-30,2,Saturday,July,2016,True,2,37419
2016-07-31,4,Sunday,July,2016,True,4,37423
2016-08-01,13,Monday,August,2016,False,13,37436
2016-08-02,30,Tuesday,August,2016,False,30,37466
2016-08-03,17,Wednesday,August,2016,False,17,37483
2016-08-04,24,Thursday,August,2016,False,24,37507
2016-08-05,9,Friday,August,2016,False,9,37516
2016-08-06,2,Saturday,August,2016,True,2,37518
2016-08-07,1,Sunday,August,2016,True,1,37519
2016-08-08,25,Monday,August,2016,False,25,37544
2016-08-09,20,Tuesday,August,2016,False,20,37564
2016-08-10,15,Wednesday,August,2016,False,15,37579
2016-08-11,10,Thursday,August,2016,False,10,37589
2016-08-12,10,Friday,August,2016,False,10,37599
2016-08-13,1,Saturday,August,2016,True,1,37600
2016-08-14,3,Sunday,August,2016,True,3,37603
2016-08-15,17,Monday,August,2016,False,17,37620
2016-08-16,31,Tuesday,August,2016,False,31,37651
2016-08-17,12,Wednesday,August,2016,False,12,37663
2016-08-18,11,Thursday,August,2016,False,11,37674
2016-08-19,4,Friday,August,2016,False,4,37678
2016-08-20,3,Saturday,August,2016,True,3,37681
2016-08-21,3,Sunday,August,2016,True,3,37684
2016-08-22,20,Monday,August,2016,False,20,37704
2016-08-23,31,Tuesday,August,2016,False,31,37735
2016-08-24,15,Wednesday,August,2016,False,15,37750
2016-08-25,13,Thursday,August,2016,False,13,37763
2016-08-26,6,Friday,August,2016,False,6,37769
2016-08-27,0,Saturday,August,2016,True,0,37769
2016-08-28,3,Sunday,August,2016,True,3,37772
2016-08-29,26,Monday,August,2016,False,26,37798
2016-08-30,16,Tuesday,August,2016,False,16,37814
2016-08-31,16,Wednesday,August,2016,False,16,37830
2016-09-01,15,Thursday,September,2016,False,15,37845
2016-09-02,10,Friday,September,2016,False,10,37855
2016-09-03,1,Saturday,September,2016,True,1,37856
2016-09-04,2,Sunday,September,2016,True,2,37858
2016-09-05,17,Monday,September,2016,False,17,37875
2016-09-06,22,Tuesday,September,2016,False,22,37897
2016-09-07,12,Wednesday,September,2016,False,12,37909
2016-09-08,21,Thursday,September,2016,False,21,37930
2016-09-09,14,Friday,September,2016,False,14,37944
2016-09-10,0,Saturday,September,2016,True,0,37944
2016-09-11,1,Sunday,September,2016,True,1,37945
2016-09-12,9,Monday,September,2016,False,9,37954
2016-09-13,5,Tuesday,September,2016,False,5,37959
2016-09-14,16,Wednesday,September,2016,False,16,37975
2016-09-15,24,Thursday,September,2016,False,24,37999
2016-09-16,11,Friday,September,2016,False,11,38010
2016-09-17,1,Saturday,September,2016,True,1,38011
2016-09-18,2,Sunday,September,2016,True,2,38013
2016-09-19,23,Monday,September,2016,False,23,38036
2016-09-20,21,Tuesday,September,2016,False,21,38057
2016-09-21,17,Wednesday,September,2016,False,17,38074
2016-09-22,24,Thursday,September,2016,False,24,38098
2016-09-23,3,Friday,September,2016,False,3,38101
2016-09-24,0,Saturday,September,2016,True,0,38101
2016-09-25,2,Sunday,September,2016,True,2,38103
2016-09-26,13,Monday,September,2016,False,13,38116
2016-09-27,21,Tuesday,September,2016,False,21,38137
2016-09-28,16,Wednesday,September,2016,False,16,38153
2016-09-29,24,Thursday,September,2016,False,24,38177
2016-09-30,9,Friday,September,2016,False,9,38186
2016-10-01,2,Saturday,October,2016,True,2,38188
2016-10-02,4,Sunday,October,2016,True,4,38192
2016-10-03,6,Monday,October,2016,False,6,38198
2016-10-04,23,Tuesday,October,2016,False,23,38221
2016-10-05,8,Wednesday,October,2016,False,8,38229
2016-10-06,14,Thursday,October,2016,False,14,38243
2016-10-07,11,Friday,October,2016,False,11,38254
2016-10-08,2,Saturday,October,2016,True,2,38256
2016-10-09,0,Sunday,October,2016,True,0,38256
2016-10-10,15,Monday,October,2016,False,15,38271
2016-10-11,19,Tuesday,October,2016,False,19,38290
2016-10-12,5,Wednesday,October,2016,False,5,38295
2016-10-13,15,Thursday,October,2016,False,15,38310
2016-10-14,14,Friday,October,2016,False,14,38324
2016-10-15,5,Saturday,October,2016,True,5,38329
2016-10-16,0,Sunday,October,2016,True,0,38329
2016-10-17,25,Monday,October,2016,False,25,38354
2016-10-18,23,Tuesday,October,2016,False,23,38377
2016-10-19,24,Wednesday,October,2016,False,24,38401
2016-10-20,8,Thursday,October,2016,False,8,38409
2016-10-21,12,Friday,October,2016,False,12,38421
2016-10-22,5,Saturday,October,2016,True,5,38426
2016-10-23,1,Sunday,October,2016,True,1,38427
2016-10-24,19,Monday,October,2016,False,19,38446
2016-10-25,22,Tuesday,October,2016,False,22,38468
2016-10-26,23,Wednesday,October,2016,False,23,38491
2016-10-27,10,Thursday,October,2016,False,10,38501
2016-10-28,6,Friday,October,2016,False,6,38507
2016-10-29,3,Saturday,October,2016,True,3,38510
2016-10-30,1,Sunday,October,2016,True,1,38511
2016-10-31,13,Monday,October,2016,False,13,38524
2016-11-01,19,Tuesday,November,2016,False,19,38543
2016-11-02,12,Wednesday,November,2016,False,12,38555
2016-11-03,27,Thursday,November,2016,False,27,38582
2016-11-04,10,Friday,November,2016,False,10,38592
2016-11-05,1,Saturday,November,2016,True,1,38593
2016-11-06,0,Sunday,November,2016,True,0,38593
2016-11-07,21,Monday,November,2016,False,21,38614
2016-11-08,20,Tuesday,November,2016,False,20,38634
2016-11-09,18,Wednesday,November,2016,False,18,38652
2016-11-10,11,Thursday,November,2016,False,11,38663
2016-11-11,9,Friday,November,2016,False,9,38672
2016-11-12,3,Saturday,November,2016,True,3,38675
2016-11-13,1,Sunday,November,2016,True,1,38676
2016-11-14,15,Monday,November,2016,False,15,38691
2016-11-15,19,Tuesday,November,2016,False,19,38710
2016-11-16,16,Wednesday,November,2016,False,16,38726
2016-11-17,18,Thursday,November,2016,False,18,38744
2016-11-18,7,Friday,November,2016,False,7,38751
2016-11-19,0,Saturday,November,2016,True,0,38751
2016-11-20,2,Sunday,November,2016,True,2,38753
2016-11-21,26,Monday,November,2016,False,26,38779
2016-11-22,15,Tuesday,November,2016,False,15,38794
2016-11-23,16,Wednesday,November,2016,False,16,38810
2016-11-24,12,Thursday,November,2016,False,12,38822
2016-11-25,3,Friday,November,2016,False,3,38825
2016-11-26,1,Saturday,November,2016,True,1,38826
2016-11-27,1,Sunday,November,2016,True,1,38827
2016-11-28,21,Monday,November,2016,False,21,38848
2016-11-29,14,Tuesday,November,2016,False,14,38862
2016-11-30,17,Wednesday,November,2016,False,17,38879
2016-12-01,17,Thursday,December,2016,False,17,38896
2016-12-02,6,Friday,December,2016,False,6,38902
2016-12-03,1,Saturday,December,2016,True,1,38903
2016-12-04,0,Sunday,December,2016,True,0,38903
2016-12-05,18,Monday,December,2016,False,18,38921
2016-12-06,22,Tuesday,December,2016,False,22,38943
2016-12-07,17,Wednesday,December,2016,False,17,38960
2016-12-08,14,Thursday,December,2016,False,14,38974
2016-12-09,6,Friday,December,2016,False,6,38980
2016-12-10,1,Saturday,December,2016,True,1,38981
2016-12-11,0,Sunday,December,2016,True,0,38981
2016-12-12,10,Monday,December,2016,False,10,38991
2016-12-13,10,Tuesday,December,2016,False,10,39001
2016-12-14,18,Wednesday,December,2016,False,18,39019
2016-12-15,18,Thursday,December,2016,False,18,39037
2016-12-16,7,Friday,December,2016,False,7,39044
2016-12-17,0,Saturday,December,2016,True,0,39044
2016-12-18,1,Sunday,December,2016,True,1,39045
2016-12-19,20,Monday,December,2016,False,20,39065
2016-12-20,14,Tuesday,December,2016,False,14,39079
2016-12-21,12,Wednesday,December,2016,False,12,39091
2016-12-22,10,Thursday,December,2016,False,10,39101
2016-12-23,4,Friday,December,2016,False,4,39105
2016-12-24,2,Saturday,December,2016,True,2,39107
2016-12-25,0,Sunday,December,2016,True,0,39107
2016-12-26,1,Monday,December,2016,False,1,39108
2016-12-27,1,Tuesday,December,2016,False,1,39109
2016-12-28,4,Wednesday,December,2016,False,4,39113
2016-12-29,5,Thursday,December,2016,False,5,39118
2016-12-30,5,Friday,December,2016,False,5,39123
2016-12-31,0,Saturday,December,2016,True,0,39123
2017-01-01,6,Sunday,January,2017,True,6,39129
2017-01-02,5,Monday,January,2017,False,5,39134
2017-01-03,11,Tuesday,January,2017,False,11,39145
2017-01-04,17,Wednesday,January,2017,False,17,39162
2017-01-05,16,Thursday,January,2017,False,16,39178
2017-01-06,12,Friday,January,2017,False,12,39190
2017-01-07,,Saturday,January,2017,True,0,39190
2017-01-08,1,Sunday,January,2017,True,1,39191
2017-01-09,26,Monday,January,2017,False,26,39217
2017-01-10,20,Tuesday,January,2017,False,20,39237
2017-01-11,19,Wednesday,January,2017,False,19,39256
2017-01-12,16,Thursday,January,2017,False,16,39272
2017-01-13,7,Friday,January,2017,False,7,39279
2017-01-14,1,Saturday,January,2017,True,1,39280
2017-01-15,1,Sunday,January,2017,True,1,39281
2017-01-16,28,Monday,January,2017,False,28,39309
2017-01-17,23,Tuesday,January,2017,False,23,39332
2017-01-18,18,Wednesday,January,2017,False,18,39350
2017-01-19,19,Thursday,January,2017,False,19,39369
2017-01-20,10,Friday,January,2017,False,10,39379
2017-01-21,1,Saturday,January,2017,True,1,39380
2017-01-22,1,Sunday,January,2017,True,1,39381
2017-01-23,21,Monday,January,2017,False,21,39402
2017-01-24,17,Tuesday,January,2017,False,17,39419
2017-01-25,11,Wednesday,January,2017,False,11,39430
2017-01-26,16,Thursday,January,2017,False,16,39446
2017-01-27,6,Friday,January,2017,False,6,39452
2017-01-28,0,Saturday,January,2017,True,0,39452
2017-01-29,,Sunday,January,2017,True,0,39452
2017-01-30,16,Monday,January,2017,False,16,39468
2017-01-31,23,Tuesday,January,2017,False,23,39491
2017-02-01,17,Wednesday,February,2017,False,17,39508
2017-02-02,18,Thursday,February,2017,False,18,39526
2017-02-03,12,Friday,February,2017,False,12,39538
2017-02-04,1,Saturday,February,2017,True,1,39539
2017-02-05,2,Sunday,February,2017,True,2,39541
2017-02-06,17,Monday,February,2017,False,17,39558
2017-02-07,20,Tuesday,February,2017,False,20,39578
2017-02-08,17,Wednesday,February,2017,False,17,39595
2017-02-09,15,Thursday,February,2017,False,15,39610
2017-02-10,13,Friday,February,2017,False,13,39623
2017-02-11,2,Saturday,February,2017,True,2,39625
2017-02-12,0,Sunday,February,2017,True,0,39625
2017-02-13,21,Monday,February,2017,False,21,39646
2017-02-14,8,Tuesday,February,2017,False,8,39654
2017-02-15,18,Wednesday,February,2017,False,18,39672
2017-02-16,13,Thursday,February,2017,False,13,39685
2017-02-17,6,Friday,February,2017,False,6,39691
2017-02-18,0,Saturday,February,2017,True,0,39691
2017-02-19,1,Sunday,February,2017,True,1,39692
2017-02-20,18,Monday,February,2017,False,18,39710
2017-02-21,23,Tuesday,February,2017,False,23,39733
2017-02-22,13,Wednesday,February,2017,False,13,39746
2017-02-23,16,Thursday,February,2017,False,16,39762
2017-02-24,5,Friday,February,2017,False,5,39767
2017-02-25,1,Saturday,February,2017,True,1,39768
2017-02-26,2,Sunday,February,2017,True,2,39770
2017-02-27,20,Monday,February,2017,False,20,39790
2017-02-28,16,Tuesday,February,2017,False,16,39806
2017-03-01,24,Wednesday,March,2017,False,24,39830
2017-03-02,15,Thursday,March,2017,False,15,39845
2017-03-03,13,Friday,March,2017,False,13,39858
2017-03-04,1,Saturday,March,2017,True,1,39859
2017-03-05,0,Sunday,March,2017,True,0,39859
2017-03-06,22,Monday,March,2017,False,22,39881
2017-03-07,14,Tuesday,March,2017,False,14,39895
2017-03-08,13,Wednesday,March,2017,False,13,39908
2017-03-09,18,Thursday,March,2017,False,18,39926
2017-03-10,8,Friday,March,2017,False,8,39934
2017-03-11,0,Saturday,March,2017,True,0,39934
2017-03-12,3,Sunday,March,2017,True,3,39937
2017-03-13,20,Monday,March,2017,False,20,39957
2017-03-14,17,Tuesday,March,2017,False,17,39974
2017-03-15,10,Wednesday,March,2017,False,10,39984
2017-03-16,9,Thursday,March,2017,False,9,39993
2017-03-17,5,Friday,March,2017,False,5,39998
2017-03-18,0,Saturday,March,2017,True,0,39998
2017-03-19,,Sunday,March,2017,True,0,39998
2017-03-20,16,Monday,March,2017,False,16,40014
2017-03-21,16,Tuesday,March,2017,False,16,40030
2017-03-22,15,Wednesday,March,2017,False,15,40045
2017-03-23,12,Thursday,March,2017,False,12,40057
2017-03-24,10,Friday,March,2017,False,10,40067
2017-03-25,2,Saturday,March,2017,True,2,40069
2017-03-26,2,Sunday,March,2017,True,2,40071
2017-03-27,17,Monday,March,2017,False,17,40088
2017-03-28,24,Tuesday,March,2017,False,24,40112
2017-03-29,13,Wednesday,March,2017,False,13,40125
2017-03-30,18,Thursday,March,2017,False,18,40143
2017-03-31,3,Friday,March,2017,False,3,40146
2017-04-01,2,Saturday,April,2017,True,2,40148
2017-04-02,0,Sunday,April,2017,True,0,40148
2017-04-03,13,Monday,April,2017,False,13,40161
2017-04-04,16,Tuesday,April,2017,False,16,40177
2017-04-05,20,Wednesday,April,2017,False,20,40197
2017-04-06,12,Thursday,April,2017,False,12,40209
2017-04-07,8,Friday,April,2017,False,8,40217
2017-04-08,1,Saturday,April,2017,True,1,40218
2017-04-09,2,Sunday,April,2017,True,2,40220
2017-04-10,10,Monday,April,2017,False,10,40230
2017-04-11,20,Tuesday,April,2017,False,20,40250
2017-04-12,4,Wednesday,April,2017,False,4,40254
2017-04-13,10,Thursday,April,2017,False,10,40264
2017-04-14,2,Friday,April,2017,False,2,40266
2017-04-15,0,Saturday,April,2017,True,0,40266
2017-04-16,1,Sunday,April,2017,True,1,40267
2017-04-17,1,Monday,April,2017,False,1,40268
2017-04-18,18,Tuesday,April,2017,False,18,40286
2017-04-19,14,Wednesday,April,2017,False,14,40300
2017-04-20,15,Thursday,April,2017,False,15,40315
2017-04-21,6,Friday,April,2017,False,6,40321
2017-04-22,1,Saturday,April,2017,True,1,40322
2017-04-23,3,Sunday,April,2017,True,3,40325
2017-04-24,13,Monday,April,2017,False,13,40338
2017-04-25,18,Tuesday,April,2017,False,18,40356
2017-04-26,12,Wednesday,April,2017,False,12,40368
2017-04-27,12,Thursday,April,2017,False,12,40380
2017-04-28,5,Friday,April,2017,False,5,40385
2017-04-29,3,Saturday,April,2017,True,3,40388
2017-04-30,3,Sunday,April,2017,True,3,40391
2017-05-01,7,Monday,May,2017,False,7,40398
2017-05-02,23,Tuesday,May,2017,False,23,40421
2017-05-03,11,Wednesday,May,2017,False,11,40432
2017-05-04,17,Thursday,May,2017,False,17,40449
2017-05-05,8,Friday,May,2017,False,8,40457
2017-05-06,1,Saturday,May,2017,True,1,40458
2017-05-07,3,Sunday,May,2017,True,3,40461
2017-05-08,16,Monday,May,2017,False,16,40477
2017-05-09,12,Tuesday,May,2017,False,12,40489
2017-05-10,9,Wednesday,May,2017,False,9,40498
2017-05-11,14,Thursday,May,2017,False,14,40512
2017-05-12,9,Friday,May,2017,False,9,40521
2017-05-13,0,Saturday,May,2017,True,0,40521
2017-05-14,2,Sunday,May,2017,True,2,40523
2017-05-15,18,Monday,May,2017,False,18,40541
2017-05-16,15,Tuesday,May,2017,False,15,40556
2017-05-17,11,Wednesday,May,2017,False,11,40567
2017-05-18,21,Thursday,May,2017,False,21,40588
2017-05-19,10,Friday,May,2017,False,10,40598
2017-05-20,3,Saturday,May,2017,True,3,40601
2017-05-21,5,Sunday,May,2017,True,5,40606
2017-05-22,14,Monday,May,2017,False,14,40620
2017-05-23,22,Tuesday,May,2017,False,22,40642
2017-05-24,9,Wednesday,May,2017,False,9,40651
2017-05-25,17,Thursday,May,2017,False,17,40668
2017-05-26,6,Friday,May,2017,False,6,40674
2017-05-27,1,Saturday,May,2017,True,1,40675
2017-05-28,0,Sunday,May,2017,True,0,40675
2017-05-29,7,Monday,May,2017,False,7,40682
2017-05-30,12,Tuesday,May,2017,False,12,40694
2017-05-31,17,Wednesday,May,2017,False,17,40711
2017-06-01,8,Thursday,June,2017,False,8,40719
2017-06-02,4,Friday,June,2017,False,4,40723
2017-06-03,3,Saturday,June,2017,True,3,40726
2017-06-04,3,Sunday,June,2017,True,3,40729
2017-06-05,15,Monday,June,2017,False,15,40744
2017-06-06,27,Tuesday,June,2017,False,27,40771
2017-06-07,11,Wednesday,June,2017,False,11,40782
2017-06-08,20,Thursday,June,2017,False,20,40802
2017-06-09,10,Friday,June,2017,False,10,40812
2017-06-10,2,Saturday,June,2017,True,2,40814
2017-06-11,4,Sunday,June,2017,True,4,40818
2017-06-12,21,Monday,June,2017,False,21,40839
2017-06-13,18,Tuesday,June,2017,False,18,40857
2017-06-14,7,Wednesday,June,2017,False,7,40864
2017-06-15,17,Thursday,June,2017,False,17,40881
2017-06-16,3,Friday,June,2017,False,3,40884
2017-06-17,3,Saturday,June,2017,True,3,40887
2017-06-18,1,Sunday,June,2017,True,1,40888
2017-06-19,15,Monday,June,2017,False,15,40903
2017-06-20,19,Tuesday,June,2017,False,19,40922
2017-06-21,13,Wednesday,June,2017,False,13,40935
2017-06-22,15,Thursday,June,2017,False,15,40950
2017-06-23,6,Friday,June,2017,False,6,40956
2017-06-24,0,Saturday,June,2017,True,0,40956
2017-06-25,1,Sunday,June,2017,True,1,40957
2017-06-26,4,Monday,June,2017,False,4,40961
2017-06-27,3,Tuesday,June,2017,False,3,40964
2017-06-28,14,Wednesday,June,2017,False,14,40978
2017-06-29,16,Thursday,June,2017,False,16,40994
2017-06-30,8,Friday,June,2017,False,8,41002
2017-07-01,0,Saturday,July,2017,True,0,41002
2017-07-02,3,Sunday,July,2017,True,3,41005
2017-07-03,30,Monday,July,2017,False,30,41035
2017-07-04,16,Tuesday,July,2017,False,16,41051
2017-07-05,7,Wednesday,July,2017,False,7,41058
2017-07-06,15,Thursday,July,2017,False,15,41073
2017-07-07,15,Friday,July,2017,False,15,41088
2017-07-08,1,Saturday,July,2017,True,1,41089
2017-07-09,2,Sunday,July,2017,True,2,41091
2017-07-10,15,Monday,July,2017,False,15,41106
2017-07-11,22,Tuesday,July,2017,False,22,41128
2017-07-12,14,Wednesday,July,2017,False,14,41142
2017-07-13,22,Thursday,July,2017,False,22,41164
2017-07-14,7,Friday,July,2017,False,7,41171
2017-07-15,0,Saturday,July,2017,True,0,41171
2017-07-16,2,Sunday,July,2017,True,2,41173
2017-07-17,20,Monday,July,2017,False,20,41193
2017-07-18,21,Tuesday,July,2017,False,21,41214
2017-07-19,12,Wednesday,July,2017,False,12,41226
2017-07-20,19,Thursday,July,2017,False,19,41245
2017-07-21,7,Friday,July,2017,False,7,41252
2017-07-22,0,Saturday,July,2017,True,0,41252
2017-07-23,2,Sunday,July,2017,True,2,41254
2017-07-24,12,Monday,July,2017,False,12,41266
2017-07-25,24,Tuesday,July,2017,False,24,41290
2017-07-26,5,Wednesday,July,2017,False,5,41295
2017-07-27,13,Thursday,July,2017,False,13,41308
2017-07-28,11,Friday,July,2017,False,11,41319
2017-07-29,3,Saturday,July,2017,True,3,41322
2017-07-30,5,Sunday,July,2017,True,5,41327
2017-07-31,20,Monday,July,2017,False,20,41347
2017-08-01,22,Tuesday,August,2017,False,22,41369
2017-08-02,12,Wednesday,August,2017,False,12,41381
2017-08-03,13,Thursday,August,2017,False,13,41394
2017-08-04,3,Friday,August,2017,False,3,41397
2017-08-05,2,Saturday,August,2017,True,2,41399
2017-08-06,1,Sunday,August,2017,True,1,41400
2017-08-07,23,Monday,August,2017,False,23,41423
2017-08-08,15,Tuesday,August,2017,False,15,41438
2017-08-09,22,Wednesday,August,2017,False,22,41460
2017-08-10,16,Thursday,August,2017,False,16,41476
2017-08-11,4,Friday,August,2017,False,4,41480
2017-08-12,1,Saturday,August,2017,True,1,41481
2017-08-13,1,Sunday,August,2017,True,1,41482
2017-08-14,14,Monday,August,2017,False,14,41496
2017-08-15,19,Tuesday,August,2017,False,19,41515
2017-08-16,13,Wednesday,August,2017,False,13,41528
2017-08-17,9,Thursday,August,2017,False,9,41537
2017-08-18,10,Friday,August,2017,False,10,41547
2017-08-19,0,Saturday,August,2017,True,0,41547
2017-08-20,0,Sunday,August,2017,True,0,41547
2017-08-21,17,Monday,August,2017,False,17,41564
2017-08-22,14,Tuesday,August,2017,False,14,41578
2017-08-23,14,Wednesday,August,2017,False,14,41592
2017-08-24,18,Thursday,August,2017,False,18,41610
2017-08-25,10,Friday,August,2017,False,10,41620
2017-08-26,2,Saturday,August,2017,True,2,41622
2017-08-27,1,Sunday,August,2017,True,1,41623
2017-08-28,17,Monday,August,2017,False,17,41640
2017-08-29,16,Tuesday,August,2017,False,16,41656
2017-08-30,11,Wednesday,August,2017,False,11,41667
2017-08-31,13,Thursday,August,2017,False,13,41680
2017-09-01,8,Friday,September,2017,False,8,41688
2017-09-02,1,Saturday,September,2017,True,1,41689
2017-09-03,2,Sunday,September,2017,True,2,41691
2017-09-04,13,Monday,September,2017,False,13,41704
2017-09-05,29,Tuesday,September,2017,False,29,41733
2017-09-06,11,Wednesday,September,2017,False,11,41744
2017-09-07,25,Thursday,September,2017,False,25,41769
2017-09-08,11,Friday,September,2017,False,11,41780
2017-09-09,0,Saturday,September,2017,True,0,41780
2017-09-10,2,Sunday,September,2017,True,2,41782
2017-09-11,20,Monday,September,2017,False,20,41802
2017-09-12,26,Tuesday,September,2017,False,26,41828
2017-09-13,15,Wednesday,September,2017,False,15,41843
2017-09-14,14,Thursday,September,2017,False,14,41857
2017-09-15,6,Friday,September,2017,False,6,41863
2017-09-16,0,Saturday,September,2017,True,0,41863
2017-09-17,2,Sunday,September,2017,True,2,41865
2017-09-18,19,Monday,September,2017,False,19,41884
2017-09-19,18,Tuesday,September,2017,False,18,41902
2017-09-20,14,Wednesday,September,2017,False,14,41916
2017-09-21,19,Thursday,September,2017,False,19,41935
2017-09-22,8,Friday,September,2017,False,8,41943
2017-09-23,1,Saturday,September,2017,True,1,41944
2017-09-24,3,Sunday,September,2017,True,3,41947
2017-09-25,23,Monday,September,2017,False,23,41970
2017-09-26,27,Tuesday,September,2017,False,27,41997
2017-09-27,17,Wednesday,September,2017,False,17,42014
2017-09-28,10,Thursday,September,2017,False,10,42024
2017-09-29,5,Friday,September,2017,False,5,42029
2017-09-30,1,Saturday,September,2017,True,1,42030
2017-10-01,2,Sunday,October,2017,True,2,42032
2017-10-02,15,Monday,October,2017,False,15,42047
2017-10-03,23,Tuesday,October,2017,False,23,42070
2017-10-04,17,Wednesday,October,2017,False,17,42087
2017-10-05,16,Thursday,October,2017,False,16,42103
2017-10-06,4,Friday,October,2017,False,4,42107
2017-10-07,2,Saturday,October,2017,True,2,42109
2017-10-08,0,Sunday,October,2017,True,0,42109
2017-10-09,13,Monday,October,2017,False,13,42122
2017-10-10,34,Tuesday,October,2017,False,34,42156
2017-10-11,15,Wednesday,October,2017,False,15,42171
2017-10-12,18,Thursday,October,2017,False,18,42189
2017-10-13,10,Friday,October,2017,False,10,42199
2017-10-14,0,Saturday,October,2017,True,0,42199
2017-10-15,4,Sunday,October,2017,True,4,42203
2017-10-16,18,Monday,October,2017,False,18,42221
2017-10-17,25,Tuesday,October,2017,False,25,42246
2017-10-18,14,Wednesday,October,2017,False,14,42260
2017-10-19,13,Thursday,October,2017,False,13,42273
2017-10-20,7,Friday,October,2017,False,7,42280
2017-10-21,3,Saturday,October,2017,True,3,42283
2017-10-22,0,Sunday,October,2017,True,0,42283
2017-10-23,21,Monday,October,2017,False,21,42304
2017-10-24,21,Tuesday,October,2017,False,21,42325
2017-10-25,12,Wednesday,October,2017,False,12,42337
2017-10-26,9,Thursday,October,2017,False,9,42346
2017-10-27,6,Friday,October,2017,False,6,42352
2017-10-28,2,Saturday,October,2017,True,2,42354
2017-10-29,2,Sunday,October,2017,True,2,42356
2017-10-30,24,Monday,October,2017,False,24,42380
2017-10-31,31,Tuesday,October,2017,False,31,42411
2017-11-01,16,Wednesday,November,2017,False,16,42427
2017-11-02,14,Thursday,November,2017,False,14,42441
2017-11-03,8,Friday,November,2017,False,8,42449
2017-11-04,1,Saturday,November,2017,True,1,42450
2017-11-05,0,Sunday,November,2017,True,0,42450
2017-11-06,14,Monday,November,2017,False,14,42464
2017-11-07,18,Tuesday,November,2017,False,18,42482
2017-11-08,19,Wednesday,November,2017,False,19,42501
2017-11-09,19,Thursday,November,2017,False,19,42520
2017-11-10,12,Friday,November,2017,False,12,42532
2017-11-11,3,Saturday,November,2017,True,3,42535
2017-11-12,0,Sunday,November,2017,True,0,42535
2017-11-13,16,Monday,November,2017,False,16,42551
2017-11-14,12,Tuesday,November,2017,False,12,42563
2017-11-15,9,Wednesday,November,2017,False,9,42572
2017-11-16,16,Thursday,November,2017,False,16,42588
2017-11-17,7,Friday,November,2017,False,7,42595
2017-11-18,0,Saturday,November,2017,True,0,42595
2017-11-19,1,Sunday,November,2017,True,1,42596
2017-11-20,22,Monday,November,2017,False,22,42618
2017-11-21,28,Tuesday,November,2017,False,28,42646
2017-11-22,17,Wednesday,November,2017,False,17,42663
2017-11-23,15,Thursday,November,2017,False,15,42678
2017-11-24,5,Friday,November,2017,False,5,42683
2017-11-25,0,Saturday,November,2017,True,0,42683
2017-11-26,0,Sunday,November,2017,True,0,42683
2017-11-27,15,Monday,November,2017,False,15,42698
2017-11-28,14,Tuesday,November,2017,False,14,42712
2017-11-29,15,Wednesday,November,2017,False,15,42727
2017-11-30,17,Thursday,November,2017,False,17,42744
2017-12-01,5,Friday,December,2017,False,5,42749
2017-12-02,2,Saturday,December,2017,True,2,42751
2017-12-03,1,Sunday,December,2017,True,1,42752
2017-12-04,13,Monday,December,2017,False,13,42765
2017-12-05,27,Tuesday,December,2017,False,27,42792
2017-12-06,9,Wednesday,December,2017,False,9,42801
2017-12-07,17,Thursday,December,2017,False,17,42818
2017-12-08,12,Friday,December,2017,False,12,42830
2017-12-09,0,Saturday,December,2017,True,0,42830
2017-12-10,0,Sunday,December,2017,True,0,42830
2017-12-11,16,Monday,December,2017,False,16,42846
2017-12-12,20,Tuesday,December,2017,False,20,42866
2017-12-13,19,Wednesday,December,2017,False,19,42885
2017-12-14,14,Thursday,December,2017,False,14,42899
2017-12-15,2,Friday,December,2017,False,2,42901
2017-12-16,0,Saturday,December,2017,True,0,42901
2017-12-17,1,Sunday,December,2017,True,1,42902
2017-12-18,13,Monday,December,2017,False,13,42915
2017-12-19,11,Tuesday,December,2017,False,11,42926
2017-12-20,14,Wednesday,December,2017,False,14,42940
2017-12-21,12,Thursday,December,2017,False,12,42952
2017-12-22,1,Friday,December,2017,False,1,42953
2017-12-23,0,Saturday,December,2017,True,0,42953
2017-12-24,1,Sunday,December,2017,True,1,42954
2017-12-25,1,Monday,December,2017,False,1,42955
2017-12-26,0,Tuesday,December,2017,False,0,42955
2017-12-27,4,Wednesday,December,2017,False,4,42959
2017-12-28,7,Thursday,December,2017,False,7,42966
2017-12-29,1,Friday,December,2017,False,1,42967
2017-12-30,0,Saturday,December,2017,True,0,42967
2017-12-31,1,Sunday,December,2017,True,1,42968
2018-01-01,10,Monday,January,2018,False,10,42978
2018-01-02,3,Tuesday,January,2018,False,3,42981
2018-01-03,0,Wednesday,January,2018,False,0,42981
2018-01-04,8,Thursday,January,2018,False,8,42989
2018-01-05,4,Friday,January,2018,False,4,42993
2018-01-06,2,Saturday,January,2018,True,2,42995
2018-01-07,2,Sunday,January,2018,True,2,42997
2018-01-08,22,Monday,January,2018,False,22,43019
2018-01-09,21,Tuesday,January,2018,False,21,43040
2018-01-10,18,Wednesday,January,2018,False,18,43058
2018-01-11,18,Thursday,January,2018,False,18,43076
2018-01-12,8,Friday,January,2018,False,8,43084
2018-01-13,1,Saturday,January,2018,True,1,43085
2018-01-14,1,Sunday,January,2018,True,1,43086
2018-01-15,24,Monday,January,2018,False,24,43110
2018-01-16,22,Tuesday,January,2018,False,22,43132
2018-01-17,16,Wednesday,January,2018,False,16,43148
2018-01-18,24,Thursday,January,2018,False,24,43172
2018-01-19,7,Friday,January,2018,False,7,43179
2018-01-20,1,Saturday,January,2018,True,1,43180
2018-01-21,0,Sunday,January,2018,True,0,43180
2018-01-22,18,Monday,January,2018,False,18,43198
2018-01-23,15,Tuesday,January,2018,False,15,43213
2018-01-24,20,Wednesday,January,2018,False,20,43233
2018-01-25,27,Thursday,January,2018,False,27,43260
2018-01-26,10,Friday,January,2018,False,10,43270
2018-01-27,0,Saturday,January,2018,True,0,43270
2018-01-28,1,Sunday,January,2018,True,1,43271
2018-01-29,18,Monday,January,2018,False,18,43289
2018-01-30,18,Tuesday,January,2018,False,18,43307
2018-01-31,5,Wednesday,January,2018,False,5,43312
2018-02-01,23,Thursday,February,2018,False,23,43335
2018-02-02,15,Friday,February,2018,False,15,43350
2018-02-03,0,Saturday,February,2018,True,0,43350
2018-02-04,0,Sunday,February,2018,True,0,43350
2018-02-05,16,Monday,February,2018,False,16,43366
2018-02-06,24,Tuesday,February,2018,False,24,43390
2018-02-07,16,Wednesday,February,2018,False,16,43406
2018-02-08,9,Thursday,February,2018,False,9,43415
2018-02-09,7,Friday,February,2018,False,7,43422
2018-02-10,0,Saturday,February,2018,True,0,43422
2018-02-11,0,Sunday,February,2018,True,0,43422
2018-02-12,16,Monday,February,2018,False,16,43438
2018-02-13,20,Tuesday,February,2018,False,20,43458
2018-02-14,18,Wednesday,February,2018,False,18,43476
2018-02-15,17,Thursday,February,2018,False,17,43493
2018-02-16,5,Friday,February,2018,False,5,43498
2018-02-17,1,Saturday,February,2018,True,1,43499
2018-02-18,1,Sunday,February,2018,True,1,43500
2018-02-19,20,Monday,February,2018,False,20,43520
2018-02-20,14,Tuesday,February,2018,False,14,43534
2018-02-21,14,Wednesday,February,2018,False,14,43548
2018-02-22,14,Thursday,February,2018,False,14,43562
2018-02-23,7,Friday,February,2018,False,7,43569
2018-02-24,1,Saturday,February,2018,True,1,43570
2018-02-25,0,Sunday,February,2018,True,0,43570
2018-02-26,9,Monday,February,2018,False,9,43579
2018-02-27,11,Tuesday,February,2018,False,11,43590
2018-02-28,8,Wednesday,February,2018,False,8,43598
2018-03-01,24,Thursday,March,2018,False,24,43622
2018-03-02,9,Friday,March,2018,False,9,43631
2018-03-03,1,Saturday,March,2018,True,1,43632
2018-03-04,1,Sunday,March,2018,True,1,43633
2018-03-05,13,Monday,March,2018,False,13,43646
2018-03-06,26,Tuesday,March,2018,False,26,43672
2018-03-07,19,Wednesday,March,2018,False,19,43691
2018-03-08,19,Thursday,March,2018,False,19,43710
2018-03-09,8,Friday,March,2018,False,8,43718
2018-03-10,4,Saturday,March,2018,True,4,43722
2018-03-11,2,Sunday,March,2018,True,2,43724
2018-03-12,16,Monday,March,2018,False,16,43740
2018-03-13,14,Tuesday,March,2018,False,14,43754
2018-03-14,12,Wednesday,March,2018,False,12,43766
2018-03-15,11,Thursday,March,2018,False,11,43777
2018-03-16,10,Friday,March,2018,False,10,43787
2018-03-17,1,Saturday,March,2018,True,1,43788
2018-03-18,0,Sunday,March,2018,True,0,43788
2018-03-19,21,Monday,March,2018,False,21,43809
2018-03-20,23,Tuesday,March,2018,False,23,43832
2018-03-21,22,Wednesday,March,2018,False,22,43854
2018-03-22,18,Thursday,March,2018,False,18,43872
2018-03-23,4,Friday,March,2018,False,4,43876
2018-03-24,1,Saturday,March,2018,True,1,43877
2018-03-25,2,Sunday,March,2018,True,2,43879
2018-03-26,21,Monday,March,2018,False,21,43900
2018-03-27,15,Tuesday,March,2018,False,15,43915
2018-03-28,8,Wednesday,March,2018,False,8,43923
2018-03-29,12,Thursday,March,2018,False,12,43935
2018-03-30,2,Friday,March,2018,False,2,43937
2018-03-31,1,Saturday,March,2018,True,1,43938
2018-04-01,2,Sunday,April,2018,True,2,43940
2018-04-02,5,Monday,April,2018,False,5,43945
2018-04-03,20,Tuesday,April,2018,False,20,43965
2018-04-04,17,Wednesday,April,2018,False,17,43982
2018-04-05,19,Thursday,April,2018,False,19,44001
2018-04-06,2,Friday,April,2018,False,2,44003
2018-04-07,1,Saturday,April,2018,True,1,44004
2018-04-08,3,Sunday,April,2018,True,3,44007
2018-04-09,16,Monday,April,2018,False,16,44023
2018-04-10,16,Tuesday,April,2018,False,16,44039
2018-04-11,11,Wednesday,April,2018,False,11,44050
2018-04-12,27,Thursday,April,2018,False,27,44077
2018-04-13,2,Friday,April,2018,False,2,44079
2018-04-14,4,Saturday,April,2018,True,4,44083
2018-04-15,1,Sunday,April,2018,True,1,44084
2018-04-16,24,Monday,April,2018,False,24,44108
2018-04-17,10,Tuesday,April,2018,False,10,44118
2018-04-18,15,Wednesday,April,2018,False,15,44133
2018-04-19,15,Thursday,April,2018,False,15,44148
2018-04-20,9,Friday,April,2018,False,9,44157
2018-04-21,0,Saturday,April,2018,True,0,44157
2018-04-22,1,Sunday,April,2018,True,1,44158
2018-04-23,12,Monday,April,2018,False,12,44170
2018-04-24,23,Tuesday,April,2018,False,23,44193
2018-04-25,15,Wednesday,April,2018,False,15,44208
2018-04-26,12,Thursday,April,2018,False,12,44220
2018-04-27,10,Friday,April,2018,False,10,44230
2018-04-28,7,Saturday,April,2018,True,7,44237
2018-04-29,2,Sunday,April,2018,True,2,44239
2018-04-30,22,Monday,April,2018,False,22,44261
2018-05-01,9,Tuesday,May,2018,False,9,44270
2018-05-02,15,Wednesday,May,2018,False,15,44285
2018-05-03,9,Thursday,May,2018,False,9,44294
2018-05-04,4,Friday,May,2018,False,4,44298
2018-05-05,8,Saturday,May,2018,True,8,44306
2018-05-06,5,Sunday,May,2018,True,5,44311
2018-05-07,17,Monday,May,2018,False,17,44328
2018-05-08,27,Tuesday,May,2018,False,27,44355
2018-05-09,11,Wednesday,May,2018,False,11,44366
2018-05-10,11,Thursday,May,2018,False,11,44377
2018-05-11,5,Friday,May,2018,False,5,44382
2018-05-12,3,Saturday,May,2018,True,3,44385
2018-05-13,0,Sunday,May,2018,True,0,44385
2018-05-14,13,Monday,May,2018,False,13,44398
2018-05-15,21,Tuesday,May,2018,False,21,44419
2018-05-16,26,Wednesday,May,2018,False,26,44445
2018-05-17,14,Thursday,May,2018,False,14,44459
2018-05-18,8,Friday,May,2018,False,8,44467
2018-05-19,1,Saturday,May,2018,True,1,44468
2018-05-20,4,Sunday,May,2018,True,4,44472
2018-05-21,22,Monday,May,2018,False,22,44494
2018-05-22,29,Tuesday,May,2018,False,29,44523
2018-05-23,13,Wednesday,May,2018,False,13,44536
2018-05-24,9,Thursday,May,2018,False,9,44545
2018-05-25,10,Friday,May,2018,False,10,44555
2018-05-26,1,Saturday,May,2018,True,1,44556
2018-05-27,0,Sunday,May,2018,True,0,44556
2018-05-28,11,Monday,May,2018,False,11,44567
2018-05-29,6,Tuesday,May,2018,False,6,44573
2018-05-30,13,Wednesday,May,2018,False,13,44586
2018-05-31,16,Thursday,May,2018,False,16,44602
2018-06-01,12,Friday,June,2018,False,12,44614
2018-06-02,3,Saturday,June,2018,True,3,44617
2018-06-03,4,Sunday,June,2018,True,4,44621
2018-06-04,15,Monday,June,2018,False,15,44636
2018-06-05,30,Tuesday,June,2018,False,30,44666
2018-06-06,22,Wednesday,June,2018,False,22,44688
2018-06-07,16,Thursday,June,2018,False,16,44704
2018-06-08,8,Friday,June,2018,False,8,44712
2018-06-09,4,Saturday,June,2018,True,4,44716
2018-06-10,0,Sunday,June,2018,True,0,44716
2018-06-11,13,Monday,June,2018,False,13,44729
2018-06-12,14,Tuesday,June,2018,False,14,44743
2018-06-13,15,Wednesday,June,2018,False,15,44758
2018-06-14,15,Thursday,June,2018,False,15,44773
2018-06-15,11,Friday,June,2018,False,11,44784
2018-06-16,1,Saturday,June,2018,True,1,44785
2018-06-17,1,Sunday,June,2018,True,1,44786
2018-06-18,11,Monday,June,2018,False,11,44797
2018-06-19,26,Tuesday,June,2018,False,26,44823
2018-06-20,10,Wednesday,June,2018,False,10,44833
2018-06-21,17,Thursday,June,2018,False,17,44850
2018-06-22,6,Friday,June,2018,False,6,44856
2018-06-23,4,Saturday,June,2018,True,4,44860
2018-06-24,0,Sunday,June,2018,True,0,44860
2018-06-25,20,Monday,June,2018,False,20,44880
2018-06-26,21,Tuesday,June,2018,False,21,44901
2018-06-27,11,Wednesday,June,2018,False,11,44912
2018-06-28,17,Thursday,June,2018,False,17,44929
2018-06-29,14,Friday,June,2018,False,14,44943
2018-06-30,0,Saturday,June,2018,True,0,44943
2018-07-01,2,Sunday,July,2018,True,2,44945
2018-07-02,19,Monday,July,2018,False,19,44964
2018-07-03,9,Tuesday,July,2018,False,9,44973
2018-07-04,11,Wednesday,July,2018,False,11,44984
2018-07-05,13,Thursday,July,2018,False,13,44997
2018-07-06,7,Friday,July,2018,False,7,45004
2018-07-07,2,Saturday,July,2018,True,2,45006
2018-07-08,0,Sunday,July,2018,True,0,45006
2018-07-09,17,Monday,July,2018,False,17,45023
2018-07-10,24,Tuesday,July,2018,False,24,45047
2018-07-11,17,Wednesday,July,2018,False,17,45064
2018-07-12,22,Thursday,July,2018,False,22,45086
2018-07-13,6,Friday,July,2018,False,6,45092
2018-07-14,1,Saturday,July,2018,True,1,45093
2018-07-15,2,Sunday,July,2018,True,2,45095
2018-07-16,13,Monday,July,2018,False,13,45108
2018-07-17,25,Tuesday,July,2018,False,25,45133
2018-07-18,14,Wednesday,July,2018,False,14,45147
2018-07-19,10,Thursday,July,2018,False,10,45157
2018-07-20,17,Friday,July,2018,False,17,45174
2018-07-21,3,Saturday,July,2018,True,3,45177
2018-07-22,0,Sunday,July,2018,True,0,45177
2018-07-23,21,Monday,July,2018,False,21,45198
2018-07-24,15,Tuesday,July,2018,False,15,45213
2018-07-25,12,Wednesday,July,2018,False,12,45225
2018-07-26,21,Thursday,July,2018,False,21,45246
2018-07-27,7,Friday,July,2018,False,7,45253
2018-07-28,1,Saturday,July,2018,True,1,45254
2018-07-29,0,Sunday,July,2018,True,0,45254
2018-07-30,16,Monday,July,2018,False,16,45270
2018-07-31,25,Tuesday,July,2018,False,25,45295
2018-08-01,15,Wednesday,August,2018,False,15,45310
2018-08-02,17,Thursday,August,2018,False,17,45327
2018-08-03,9,Friday,August,2018,False,9,45336
2018-08-04,1,Saturday,August,2018,True,1,45337
2018-08-05,3,Sunday,August,2018,True,3,45340
2018-08-06,22,Monday,August,2018,False,22,45362
2018-08-07,29,Tuesday,August,2018,False,29,45391
2018-08-08,19,Wednesday,August,2018,False,19,45410
2018-08-09,21,Thursday,August,2018,False,21,45431
2018-08-10,2,Friday,August,2018,False,2,45433
2018-08-11,3,Saturday,August,2018,True,3,45436
2018-08-12,1,Sunday,August,2018,True,1,45437
2018-08-13,18,Monday,August,2018,False,18,45455
2018-08-14,16,Tuesday,August,2018,False,16,45471
2018-08-15,17,Wednesday,August,2018,False,17,45488
2018-08-16,21,Thursday,August,2018,False,21,45509
2018-08-17,7,Friday,August,2018,False,7,45516
2018-08-18,1,Saturday,August,2018,True,1,45517
2018-08-19,4,Sunday,August,2018,True,4,45521
2018-08-20,16,Monday,August,2018,False,16,45537
2018-08-21,11,Tuesday,August,2018,False,11,45548
2018-08-22,6,Wednesday,August,2018,False,6,45554
2018-08-23,16,Thursday,August,2018,False,16,45570
2018-08-24,6,Friday,August,2018,False,6,45576
2018-08-25,2,Saturday,August,2018,True,2,45578
2018-08-26,1,Sunday,August,2018,True,1,45579
2018-08-27,19,Monday,August,2018,False,19,45598
2018-08-28,21,Tuesday,August,2018,False,21,45619
2018-08-29,11,Wednesday,August,2018,False,11,45630
2018-08-30,15,Thursday,August,2018,False,15,45645
2018-08-31,11,Friday,August,2018,False,11,45656
2018-09-01,3,Saturday,September,2018,True,3,45659
2018-09-02,1,Sunday,September,2018,True,1,45660
2018-09-03,21,Monday,September,2018,False,21,45681
2018-09-04,27,Tuesday,September,2018,False,27,45708
2018-09-05,17,Wednesday,September,2018,False,17,45725
2018-09-06,20,Thursday,September,2018,False,20,45745
2018-09-07,6,Friday,September,2018,False,6,45751
2018-09-08,2,Saturday,September,2018,True,2,45753
2018-09-09,5,Sunday,September,2018,True,5,45758
2018-09-10,26,Monday,September,2018,False,26,45784
2018-09-11,16,Tuesday,September,2018,False,16,45800
2018-09-12,16,Wednesday,September,2018,False,16,45816
2018-09-13,16,Thursday,September,2018,False,16,45832
2018-09-14,10,Friday,September,2018,False,10,45842
2018-09-15,2,Saturday,September,2018,True,2,45844
2018-09-16,3,Sunday,September,2018,True,3,45847
2018-09-17,21,Monday,September,2018,False,21,45868
2018-09-18,14,Tuesday,September,2018,False,14,45882
2018-09-19,19,Wednesday,September,2018,False,19,45901
2018-09-20,24,Thursday,September,2018,False,24,45925
2018-09-21,9,Friday,September,2018,False,9,45934
2018-09-22,1,Saturday,September,2018,True,1,45935
2018-09-23,1,Sunday,September,2018,True,1,45936
2018-09-24,14,Monday,September,2018,False,14,45950
2018-09-25,22,Tuesday,September,2018,False,22,45972
2018-09-26,14,Wednesday,September,2018,False,14,45986
2018-09-27,16,Thursday,September,2018,False,16,46002
2018-09-28,12,Friday,September,2018,False,12,46014
2018-09-29,3,Saturday,September,2018,True,3,46017
2018-09-30,0,Sunday,September,2018,True,0,46017
2018-10-01,5,Monday,October,2018,False,5,46022
2018-10-02,22,Tuesday,October,2018,False,22,46044
2018-10-03,19,Wednesday,October,2018,False,19,46063
2018-10-04,21,Thursday,October,2018,False,21,46084
2018-10-05,6,Friday,October,2018,False,6,46090
2018-10-06,3,Saturday,October,2018,True,3,46093
2018-10-07,2,Sunday,October,2018,True,2,46095
2018-10-08,21,Monday,October,2018,False,21,46116
2018-10-09,20,Tuesday,October,2018,False,20,46136
2018-10-10,17,Wednesday,October,2018,False,17,46153
2018-10-11,13,Thursday,October,2018,False,13,46166
2018-10-12,7,Friday,October,2018,False,7,46173
2018-10-13,1,Saturday,October,2018,True,1,46174
2018-10-14,1,Sunday,October,2018,True,1,46175
2018-10-15,16,Monday,October,2018,False,16,46191
2018-10-16,14,Tuesday,October,2018,False,14,46205
2018-10-17,18,Wednesday,October,2018,False,18,46223
2018-10-18,18,Thursday,October,2018,False,18,46241
2018-10-19,13,Friday,October,2018,False,13,46254
2018-10-20,4,Saturday,October,2018,True,4,46258
2018-10-21,0,Sunday,October,2018,True,0,46258
2018-10-22,14,Monday,October,2018,False,14,46272
2018-10-23,29,Tuesday,October,2018,False,29,46301
2018-10-24,11,Wednesday,October,2018,False,11,46312
2018-10-25,13,Thursday,October,2018,False,13,46325
2018-10-26,3,Friday,October,2018,False,3,46328
2018-10-27,1,Saturday,October,2018,True,1,46329
2018-10-28,1,Sunday,October,2018,True,1,46330
2018-10-29,17,Monday,October,2018,False,17,46347
2018-10-30,17,Tuesday,October,2018,False,17,46364
2018-10-31,15,Wednesday,October,2018,False,15,46379
2018-11-01,21,Thursday,November,2018,False,21,46400
2018-11-02,8,Friday,November,2018,False,8,46408
2018-11-03,0,Saturday,November,2018,True,0,46408
2018-11-04,0,Sunday,November,2018,True,0,46408
2018-11-05,12,Monday,November,2018,False,12,46420
2018-11-06,18,Tuesday,November,2018,False,18,46438
2018-11-07,12,Wednesday,November,2018,False,12,46450
2018-11-08,16,Thursday,November,2018,False,16,46466
2018-11-09,6,Friday,November,2018,False,6,46472
2018-11-10,1,Saturday,November,2018,True,1,46473
2018-11-11,2,Sunday,November,2018,True,2,46475
2018-11-12,21,Monday,November,2018,False,21,46496
2018-11-13,8,Tuesday,November,2018,False,8,46504
2018-11-14,16,Wednesday,November,2018,False,16,46520
2018-11-15,13,Thursday,November,2018,False,13,46533
2018-11-16,13,Friday,November,2018,False,13,46546
2018-11-17,1,Saturday,November,2018,True,1,46547
2018-11-18,0,Sunday,November,2018,True,0,46547
2018-11-19,24,Monday,November,2018,False,24,46571
2018-11-20,6,Tuesday,November,2018,False,6,46577
2018-11-21,8,Wednesday,November,2018,False,8,46585
2018-11-22,18,Thursday,November,2018,False,18,46603
2018-11-23,9,Friday,November,2018,False,9,46612
2018-11-24,0,Saturday,November,2018,True,0,46612
2018-11-25,4,Sunday,November,2018,True,4,46616
2018-11-26,16,Monday,November,2018,False,16,46632
2018-11-27,21,Tuesday,November,2018,False,21,46653
2018-11-28,10,Wednesday,November,2018,False,10,46663
2018-11-29,13,Thursday,November,2018,False,13,46676
2018-11-30,8,Friday,November,2018,False,8,46684
2018-12-01,1,Saturday,December,2018,True,1,46685
2018-12-02,0,Sunday,December,2018,True,0,46685
2018-12-03,23,Monday,December,2018,False,23,46708
2018-12-04,13,Tuesday,December,2018,False,13,46721
2018-12-05,28,Wednesday,December,2018,False,28,46749
2018-12-06,8,Thursday,December,2018,False,8,46757
2018-12-07,7,Friday,December,2018,False,7,46764
2018-12-08,0,Saturday,December,2018,True,0,46764
2018-12-09,1,Sunday,December,2018,True,1,46765
2018-12-10,16,Monday,December,2018,False,16,46781
2018-12-11,17,Tuesday,December,2018,False,17,46798
2018-12-12,16,Wednesday,December,2018,False,16,46814
2018-12-13,19,Thursday,December,2018,False,19,46833
2018-12-14,6,Friday,December,2018,False,6,46839
2018-12-15,2,Saturday,December,2018,True,2,46841
2018-12-16,1,Sunday,December,2018,True,1,46842
2018-12-17,19,Monday,December,2018,False,19,46861
2018-12-18,9,Tuesday,December,2018,False,9,46870
2018-12-19,13,Wednesday,December,2018,False,13,46883
2018-12-20,13,Thursday,December,2018,False,13,46896
2018-12-21,8,Friday,December,2018,False,8,46904
2018-12-22,1,Saturday,December,2018,True,1,46905
2018-12-23,1,Sunday,December,2018,True,1,46906
2018-12-24,10,Monday,December,2018,False,10,46916
2018-12-25,0,Tuesday,December,2018,False,0,46916
2018-12-26,1,Wednesday,December,2018,False,1,46917
2018-12-27,4,Thursday,December,2018,False,4,46921
2018-12-28,4,Friday,December,2018,False,4,46925
2018-12-29,2,Saturday,December,2018,True,2,46927
2018-12-30,0,Sunday,December,2018,True,0,46927
2018-12-31,7,Monday,December,2018,False,7,46934
2019-01-01,7,Tuesday,January,2019,False,7,46941
2019-01-02,5,Wednesday,January,2019,False,5,46946
2019-01-03,6,Thursday,January,2019,False,6,46952
2019-01-04,5,Friday,January,2019,False,5,46957
2019-01-05,5,Saturday,January,2019,True,5,46962
2019-01-06,1,Sunday,January,2019,True,1,46963
2019-01-07,23,Monday,January,2019,False,23,46986
2019-01-08,21,Tuesday,January,2019,False,21,47007
2019-01-09,22,Wednesday,January,2019,False,22,47029
2019-01-10,17,Thursday,January,2019,False,17,47046
2019-01-11,13,Friday,January,2019,False,13,47059
2019-01-12,1,Saturday,January,2019,True,1,47060
2019-01-13,1,Sunday,January,2019,True,1,47061
2019-01-14,28,Monday,January,2019,False,28,47089
2019-01-15,27,Tuesday,January,2019,False,27,47116
2019-01-16,14,Wednesday,January,2019,False,14,47130
2019-01-17,14,Thursday,January,2019,False,14,47144
2019-01-18,10,Friday,January,2019,False,10,47154
2019-01-19,0,Saturday,January,2019,True,0,47154
2019-01-20,0,Sunday,January,2019,True,0,47154
2019-01-21,16,Monday,January,2019,False,16,47170
2019-01-22,17,Tuesday,January,2019,False,17,47187
2019-01-23,23,Wednesday,January,2019,False,23,47210
2019-01-24,13,Thursday,January,2019,False,13,47223
2019-01-25,9,Friday,January,2019,False,9,47232
2019-01-26,3,Saturday,January,2019,True,3,47235
2019-01-27,1,Sunday,January,2019,True,1,47236
2019-01-28,19,Monday,January,2019,False,19,47255
2019-01-29,23,Tuesday,January,2019,False,23,47278
2019-01-30,20,Wednesday,January,2019,False,20,47298
2019-01-31,20,Thursday,January,2019,False,20,47318
2019-02-01,11,Friday,February,2019,False,11,47329
2019-02-02,1,Saturday,February,2019,True,1,47330
2019-02-03,2,Sunday,February,2019,True,2,47332
2019-02-04,15,Monday,February,2019,False,15,47347
2019-02-05,19,Tuesday,February,2019,False,19,47366
2019-02-06,15,Wednesday,February,2019,False,15,47381
2019-02-07,12,Thursday,February,2019,False,12,47393
2019-02-08,15,Friday,February,2019,False,15,47408
2019-02-09,3,Saturday,February,2019,True,3,47411
2019-02-10,0,Sunday,February,2019,True,0,47411
2019-02-11,21,Monday,February,2019,False,21,47432
2019-02-12,13,Tuesday,February,2019,False,13,47445
2019-02-13,8,Wednesday,February,2019,False,8,47453
2019-02-14,9,Thursday,February,2019,False,9,47462
2019-02-15,9,Friday,February,2019,False,9,47471
2019-02-16,0,Saturday,February,2019,True,0,47471
2019-02-17,0,Sunday,February,2019,True,0,47471
2019-02-18,23,Monday,February,2019,False,23,47494
2019-02-19,18,Tuesday,February,2019,False,18,47512
2019-02-20,11,Wednesday,February,2019,False,11,47523
2019-02-21,14,Thursday,February,2019,False,14,47537
2019-02-22,4,Friday,February,2019,False,4,47541
2019-02-23,0,Saturday,February,2019,True,0,47541
2019-02-24,1,Sunday,February,2019,True,1,47542
2019-02-25,13,Monday,February,2019,False,13,47555
2019-02-26,13,Tuesday,February,2019,False,13,47568
2019-02-27,16,Wednesday,February,2019,False,16,47584
2019-02-28,17,Thursday,February,2019,False,17,47601
2019-03-01,7,Friday,March,2019,False,7,47608
2019-03-02,1,Saturday,March,2019,True,1,47609
2019-03-03,0,Sunday,March,2019,True,0,47609
2019-03-04,14,Monday,March,2019,False,14,47623
2019-03-05,10,Tuesday,March,2019,False,10,47633
2019-03-06,11,Wednesday,March,2019,False,11,47644
2019-03-07,14,Thursday,March,2019,False,14,47658
2019-03-08,5,Friday,March,2019,False,5,47663
2019-03-09,3,Saturday,March,2019,True,3,47666
2019-03-10,1,Sunday,March,2019,True,1,47667
2019-03-11,19,Monday,March,2019,False,19,47686
2019-03-12,17,Tuesday,March,2019,False,17,47703
2019-03-13,21,Wednesday,March,2019,False,21,47724
2019-03-14,12,Thursday,March,2019,False,12,47736
2019-03-15,6,Friday,March,2019,False,6,47742
2019-03-16,1,Saturday,March,2019,True,1,47743
2019-03-17,2,Sunday,March,2019,True,2,47745
2019-03-18,9,Monday,March,2019,False,9,47754
2019-03-19,16,Tuesday,March,2019,False,16,47770
2019-03-20,14,Wednesday,March,2019,False,14,47784
2019-03-21,14,Thursday,March,2019,False,14,47798
2019-03-22,2,Friday,March,2019,False,2,47800
2019-03-23,3,Saturday,March,2019,True,3,47803
2019-03-24,5,Sunday,March,2019,True,5,47808
2019-03-25,14,Monday,March,2019,False,14,47822
2019-03-26,18,Tuesday,March,2019,False,18,47840
2019-03-27,15,Wednesday,March,2019,False,15,47855
2019-03-28,17,Thursday,March,2019,False,17,47872
2019-03-29,8,Friday,March,2019,False,8,47880
2019-03-30,3,Saturday,March,2019,True,3,47883
2019-03-31,2,Sunday,March,2019,True,2,47885
2019-04-01,15,Monday,April,2019,False,15,47900
2019-04-02,18,Tuesday,April,2019,False,18,47918
2019-04-03,18,Wednesday,April,2019,False,18,47936
2019-04-04,20,Thursday,April,2019,False,20,47956
2019-04-05,6,Friday,April,2019,False,6,47962
2019-04-06,3,Saturday,April,2019,True,3,47965
2019-04-07,1,Sunday,April,2019,True,1,47966
2019-04-08,21,Monday,April,2019,False,21,47987
2019-04-09,15,Tuesday,April,2019,False,15,48002
2019-04-10,15,Wednesday,April,2019,False,15,48017
2019-04-11,17,Thursday,April,2019,False,17,48034
2019-04-12,5,Friday,April,2019,False,5,48039
2019-04-13,3,Saturday,April,2019,True,3,48042
2019-04-14,2,Sunday,April,2019,True,2,48044
2019-04-15,15,Monday,April,2019,False,15,48059
2019-04-16,15,Tuesday,April,2019,False,15,48074
2019-04-17,13,Wednesday,April,2019,False,13,48087
2019-04-18,16,Thursday,April,2019,False,16,48103
2019-04-19,1,Friday,April,2019,False,1,48104
2019-04-20,5,Saturday,April,2019,True,5,48109
2019-04-21,1,Sunday,April,2019,True,1,48110
2019-04-22,6,Monday,April,2019,False,6,48116
2019-04-23,18,Tuesday,April,2019,False,18,48134
2019-04-24,13,Wednesday,April,2019,False,13,48147
2019-04-25,19,Thursday,April,2019,False,19,48166
2019-04-26,4,Friday,April,2019,False,4,48170
2019-04-27,3,Saturday,April,2019,True,3,48173
2019-04-28,2,Sunday,April,2019,True,2,48175
2019-04-29,17,Monday,April,2019,False,17,48192
2019-04-30,22,Tuesday,April,2019,False,22,48214
2019-05-01,9,Wednesday,May,2019,False,9,48223
2019-05-02,24,Thursday,May,2019,False,24,48247
2019-05-03,8,Friday,May,2019,False,8,48255
2019-05-04,3,Saturday,May,2019,True,3,48258
2019-05-05,1,Sunday,May,2019,True,1,48259
2019-05-06,28,Monday,May,2019,False,28,48287
2019-05-07,21,Tuesday,May,2019,False,21,48308
2019-05-08,9,Wednesday,May,2019,False,9,48317
2019-05-09,10,Thursday,May,2019,False,10,48327
2019-05-10,4,Friday,May,2019,False,4,48331
2019-05-11,3,Saturday,May,2019,True,3,48334
2019-05-12,3,Sunday,May,2019,True,3,48337
2019-05-13,29,Monday,May,2019,False,29,48366
2019-05-14,22,Tuesday,May,2019,False,22,48388
2019-05-15,10,Wednesday,May,2019,False,10,48398
2019-05-16,10,Thursday,May,2019,False,10,48408
2019-05-17,9,Friday,May,2019,False,9,48417
2019-05-18,4,Saturday,May,2019,True,4,48421
2019-05-19,3,Sunday,May,2019,True,3,48424
2019-05-20,27,Monday,May,2019,False,27,48451
2019-05-21,15,Tuesday,May,2019,False,15,48466
2019-05-22,7,Wednesday,May,2019,False,7,48473
2019-05-23,29,Thursday,May,2019,False,29,48502
2019-05-24,13,Friday,May,2019,False,13,48515
2019-05-25,2,Saturday,May,2019,True,2,48517
2019-05-26,2,Sunday,May,2019,True,2,48519
2019-05-27,15,Monday,May,2019,False,15,48534
2019-05-28,15,Tuesday,May,2019,False,15,48549
2019-05-29,12,Wednesday,May,2019,False,12,48561
2019-05-30,24,Thursday,May,2019,False,24,48585
2019-05-31,8,Friday,May,2019,False,8,48593
2019-06-01,1,Saturday,June,2019,True,1,48594
2019-06-02,2,Sunday,June,2019,True,2,48596
2019-06-03,27,Monday,June,2019,False,27,48623
2019-06-04,14,Tuesday,June,2019,False,14,48637
2019-06-05,13,Wednesday,June,2019,False,13,48650
2019-06-06,19,Thursday,June,2019,False,19,48669
2019-06-07,7,Friday,June,2019,False,7,48676
2019-06-08,4,Saturday,June,2019,True,4,48680
2019-06-09,5,Sunday,June,2019,True,5,48685
2019-06-10,32,Monday,June,2019,False,32,48717
2019-06-11,16,Tuesday,June,2019,False,16,48733
2019-06-12,6,Wednesday,June,2019,False,6,48739
2019-06-13,22,Thursday,June,2019,False,22,48761
2019-06-14,9,Friday,June,2019,False,9,48770
2019-06-15,5,Saturday,June,2019,True,5,48775
2019-06-16,1,Sunday,June,2019,True,1,48776
2019-06-17,32,Monday,June,2019,False,32,48808
2019-06-18,17,Tuesday,June,2019,False,17,48825
2019-06-19,13,Wednesday,June,2019,False,13,48838
2019-06-20,13,Thursday,June,2019,False,13,48851
2019-06-21,17,Friday,June,2019,False,17,48868
2019-06-22,3,Saturday,June,2019,True,3,48871
2019-06-23,2,Sunday,June,2019,True,2,48873
2019-06-24,9,Monday,June,2019,False,9,48882
2019-06-25,37,Tuesday,June,2019,False,37,48919
2019-06-26,16,Wednesday,June,2019,False,16,48935
2019-06-27,13,Thursday,June,2019,False,13,48948
2019-06-28,7,Friday,June,2019,False,7,48955
2019-06-29,3,Saturday,June,2019,True,3,48958
2019-06-30,1,Sunday,June,2019,True,1,48959
2019-07-01,21,Monday,July,2019,False,21,48980
2019-07-02,14,Tuesday,July,2019,False,14,48994
2019-07-03,12,Wednesday,July,2019,False,12,49006
2019-07-04,14,Thursday,July,2019,False,14,49020
2019-07-05,6,Friday,July,2019,False,6,49026
2019-07-06,4,Saturday,July,2019,True,4,49030
2019-07-07,1,Sunday,July,2019,True,1,49031
2019-07-08,22,Monday,July,2019,False,22,49053
2019-07-09,14,Tuesday,July,2019,False,14,49067
2019-07-10,19,Wednesday,July,2019,False,19,49086
2019-07-11,19,Thursday,July,2019,False,19,49105
2019-07-12,6,Friday,July,2019,False,6,49111
2019-07-13,4,Saturday,July,2019,True,4,49115
2019-07-14,1,Sunday,July,2019,True,1,49116
2019-07-15,21,Monday,July,2019,False,21,49137
2019-07-16,19,Tuesday,July,2019,False,19,49156
2019-07-17,23,Wednesday,July,2019,False,23,49179
2019-07-18,16,Thursday,July,2019,False,16,49195
2019-07-19,12,Friday,July,2019,False,12,49207
2019-07-20,0,Saturday,July,2019,True,0,49207
2019-07-21,2,Sunday,July,2019,True,2,49209
2019-07-22,21,Monday,July,2019,False,21,49230
2019-07-23,17,Tuesday,July,2019,False,17,49247
2019-07-24,7,Wednesday,July,2019,False,7,49254
2019-07-25,19,Thursday,July,2019,False,19,49273
2019-07-26,7,Friday,July,2019,False,7,49280
2019-07-27,2,Saturday,July,2019,True,2,49282
2019-07-28,1,Sunday,July,2019,True,1,49283
2019-07-29,13,Monday,July,2019,False,13,49296
2019-07-30,18,Tuesday,July,2019,False,18,49314
2019-07-31,16,Wednesday,July,2019,False,16,49330
2019-08-01,23,Thursday,August,2019,False,23,49353
2019-08-02,10,Friday,August,2019,False,10,49363
2019-08-03,2,Saturday,August,2019,True,2,49365
2019-08-04,0,Sunday,August,2019,True,0,49365
2019-08-05,19,Monday,August,2019,False,19,49384
2019-08-06,22,Tuesday,August,2019,False,22,49406
2019-08-07,16,Wednesday,August,2019,False,16,49422
2019-08-08,28,Thursday,August,2019,False,28,49450
2019-08-09,22,Friday,August,2019,False,22,49472
2019-08-10,1,Saturday,August,2019,True,1,49473
2019-08-11,4,Sunday,August,2019,True,4,49477
2019-08-12,14,Monday,August,2019,False,14,49491
2019-08-13,9,Tuesday,August,2019,False,9,49500
2019-08-14,25,Wednesday,August,2019,False,25,49525
2019-08-15,31,Thursday,August,2019,False,31,49556
2019-08-16,12,Friday,August,2019,False,12,49568
2019-08-17,2,Saturday,August,2019,True,2,49570
2019-08-18,1,Sunday,August,2019,True,1,49571
2019-08-19,20,Monday,August,2019,False,20,49591
2019-08-20,31,Tuesday,August,2019,False,31,49622
2019-08-21,8,Wednesday,August,2019,False,8,49630
2019-08-22,23,Thursday,August,2019,False,23,49653
2019-08-23,7,Friday,August,2019,False,7,49660
2019-08-24,4,Saturday,August,2019,True,4,49664
2019-08-25,3,Sunday,August,2019,True,3,49667
2019-08-26,27,Monday,August,2019,False,27,49694
2019-08-27,24,Tuesday,August,2019,False,24,49718
2019-08-28,22,Wednesday,August,2019,False,22,49740
2019-08-29,22,Thursday,August,2019,False,22,49762
2019-08-30,23,Friday,August,2019,False,23,49785
2019-08-31,1,Saturday,August,2019,True,1,49786
2019-09-01,2,Sunday,September,2019,True,2,49788
2019-09-02,21,Monday,September,2019,False,21,49809
2019-09-03,22,Tuesday,September,2019,False,22,49831
2019-09-04,17,Wednesday,September,2019,False,17,49848
2019-09-05,26,Thursday,September,2019,False,26,49874
2019-09-06,36,Friday,September,2019,False,36,49910
2019-09-07,1,Saturday,September,2019,True,1,49911
2019-09-08,2,Sunday,September,2019,True,2,49913
2019-09-09,20,Monday,September,2019,False,20,49933
2019-09-10,17,Tuesday,September,2019,False,17,49950
2019-09-11,19,Wednesday,September,2019,False,19,49969
2019-09-12,27,Thursday,September,2019,False,27,49996
2019-09-13,33,Friday,September,2019,False,33,50029
2019-09-14,3,Saturday,September,2019,True,3,50032
2019-09-15,1,Sunday,September,2019,True,1,50033
2019-09-16,15,Monday,September,2019,False,15,50048
2019-09-17,35,Tuesday,September,2019,False,35,50083
2019-09-18,15,Wednesday,September,2019,False,15,50098
2019-09-19,32,Thursday,September,2019,False,32,50130
2019-09-20,19,Friday,September,2019,False,19,50149
2019-09-21,8,Saturday,September,2019,True,8,50157
2019-09-22,4,Sunday,September,2019,True,4,50161
2019-09-23,31,Monday,September,2019,False,31,50192
2019-09-24,18,Tuesday,September,2019,False,18,50210
2019-09-25,8,Wednesday,September,2019,False,8,50218
2019-09-26,17,Thursday,September,2019,False,17,50235
2019-09-27,13,Friday,September,2019,False,13,50248
2019-09-28,2,Saturday,September,2019,True,2,50250
2019-09-29,5,Sunday,September,2019,True,5,50255
2019-09-30,17,Monday,September,2019,False,17,50272
2019-10-01,10,Tuesday,October,2019,False,10,50282
2019-10-02,17,Wednesday,October,2019,False,17,50299
2019-10-03,10,Thursday,October,2019,False,10,50309
2019-10-04,16,Friday,October,2019,False,16,50325
2019-10-05,1,Saturday,October,2019,True,1,50326
2019-10-06,1,Sunday,October,2019,True,1,50327
2019-10-07,29,Monday,October,2019,False,29,50356
2019-10-08,17,Tuesday,October,2019,False,17,50373
2019-10-09,11,Wednesday,October,2019,False,11,50384
2019-10-10,27,Thursday,October,2019,False,27,50411
2019-10-11,12,Friday,October,2019,False,12,50423
2019-10-12,5,Saturday,October,2019,True,5,50428
2019-10-13,3,Sunday,October,2019,True,3,50431
2019-10-14,29,Monday,October,2019,False,29,50460
2019-10-15,27,Tuesday,October,2019,False,27,50487
2019-10-16,31,Wednesday,October,2019,False,31,50518
2019-10-17,21,Thursday,October,2019,False,21,50539
2019-10-18,29,Friday,October,2019,False,29,50568
2019-10-19,8,Saturday,October,2019,True,8,50576
2019-10-20,1,Sunday,October,2019,True,1,50577
2019-10-21,33,Monday,October,2019,False,33,50610
2019-10-22,17,Tuesday,October,2019,False,17,50627
2019-10-23,28,Wednesday,October,2019,False,28,50655
2019-10-24,28,Thursday,October,2019,False,28,50683
2019-10-25,15,Friday,October,2019,False,15,50698
2019-10-26,0,Saturday,October,2019,True,0,50698
2019-10-27,4,Sunday,October,2019,True,4,50702
2019-10-28,25,Monday,October,2019,False,25,50727
2019-10-29,27,Tuesday,October,2019,False,27,50754
2019-10-30,20,Wednesday,October,2019,False,20,50774
2019-10-31,37,Thursday,October,2019,False,37,50811
2019-11-01,18,Friday,November,2019,False,18,50829
2019-11-02,0,Saturday,November,2019,True,0,50829
2019-11-03,0,Sunday,November,2019,True,0,50829
2019-11-04,32,Monday,November,2019,False,32,50861
2019-11-05,18,Tuesday,November,2019,False,18,50879
2019-11-06,20,Wednesday,November,2019,False,20,50899
2019-11-07,20,Thursday,November,2019,False,20,50919
2019-11-08,17,Friday,November,2019,False,17,50936
2019-11-09,2,Saturday,November,2019,True,2,50938
2019-11-10,2,Sunday,November,2019,True,2,50940
2019-11-11,7,Monday,November,2019,False,7,50947
2019-11-12,38,Tuesday,November,2019,False,38,50985
2019-11-13,19,Wednesday,November,2019,False,19,51004
2019-11-14,23,Thursday,November,2019,False,23,51027
2019-11-15,50,Friday,November,2019,False,50,51077
2019-11-16,1,Saturday,November,2019,True,1,51078
2019-11-17,0,Sunday,November,2019,True,0,51078
2019-11-18,26,Monday,November,2019,False,26,51104
2019-11-19,22,Tuesday,November,2019,False,22,51126
2019-11-20,24,Wednesday,November,2019,False,24,51150
2019-11-21,37,Thursday,November,2019,False,37,51187
2019-11-22,24,Friday,November,2019,False,24,51211
2019-11-23,3,Saturday,November,2019,True,3,51214
2019-11-24,3,Sunday,November,2019,True,3,51217
2019-11-25,36,Monday,November,2019,False,36,51253
2019-11-26,18,Tuesday,November,2019,False,18,51271
2019-11-27,18,Wednesday,November,2019,False,18,51289
2019-11-28,33,Thursday,November,2019,False,33,51322
2019-11-29,48,Friday,November,2019,False,48,51370
2019-11-30,0,Saturday,November,2019,True,0,51370
2019-12-01,,Sunday,December,2019,True,0,51370
2019-12-02,25,Monday,December,2019,False,25,51395
2019-12-03,48,Tuesday,December,2019,False,48,51443
2019-12-04,16,Wednesday,December,2019,False,16,51459
2019-12-05,30,Thursday,December,2019,False,30,51489
2019-12-06,42,Friday,December,2019,False,42,51531
2019-12-07,4,Saturday,December,2019,True,4,51535
2019-12-08,1,Sunday,December,2019,True,1,51536
2019-12-09,31,Monday,December,2019,False,31,51567
2019-12-10,24,Tuesday,December,2019,False,24,51591
2019-12-11,25,Wednesday,December,2019,False,25,51616
2019-12-12,19,Thursday,December,2019,False,19,51635
2019-12-13,70,Friday,December,2019,False,70,51705
2019-12-14,2,Saturday,December,2019,True,2,51707
2019-12-15,6,Sunday,December,2019,True,6,51713
2019-12-16,23,Monday,December,2019,False,23,51736
2019-12-17,15,Tuesday,December,2019,False,15,51751
2019-12-18,20,Wednesday,December,2019,False,20,51771
2019-12-19,28,Thursday,December,2019,False,28,51799
2019-12-20,53,Friday,December,2019,False,53,51852
2019-12-21,2,Saturday,December,2019,True,2,51854
2019-12-22,1,Sunday,December,2019,True,1,51855
2019-12-23,27,Monday,December,2019,False,27,51882
2019-12-24,15,Tuesday,December,2019,False,15,51897
2019-12-25,1,Wednesday,December,2019,False,1,51898
2019-12-26,0,Thursday,December,2019,False,0,51898
2019-12-27,24,Friday,December,2019,False,24,51922
2019-12-28,1,Saturday,December,2019,True,1,51923
2019-12-29,0,Sunday,December,2019,True,0,51923
2019-12-30,20,Monday,December,2019,False,20,51943
2019-12-31,13,Tuesday,December,2019,False,13,51956
2020-01-01,20,Wednesday,January,2020,False,20,51976
2020-01-02,32,Thursday,January,2020,False,32,52008
2020-01-03,47,Friday,January,2020,False,47,52055
2020-01-04,1,Saturday,January,2020,True,1,52056
2020-01-05,0,Sunday,January,2020,True,0,52056
2020-01-06,34,Monday,January,2020,False,34,52090
2020-01-07,25,Tuesday,January,2020,False,25,52115
2020-01-08,30,Wednesday,January,2020,False,30,52145
2020-01-09,27,Thursday,January,2020,False,27,52172
2020-01-10,67,Friday,January,2020,False,67,52239
2020-01-11,7,Saturday,January,2020,True,7,52246
2020-01-12,0,Sunday,January,2020,True,0,52246
2020-01-13,26,Monday,January,2020,False,26,52272
2020-01-14,30,Tuesday,January,2020,False,30,52302
2020-01-15,23,Wednesday,January,2020,False,23,52325
2020-01-16,40,Thursday,January,2020,False,40,52365
2020-01-17,56,Friday,January,2020,False,56,52421
2020-01-18,0,Saturday,January,2020,True,0,52421
2020-01-19,1,Sunday,January,2020,True,1,52422
2020-01-20,40,Monday,January,2020,False,40,52462
2020-01-21,22,Tuesday,January,2020,False,22,52484
2020-01-22,23,Wednesday,January,2020,False,23,52507
2020-01-23,21,Thursday,January,2020,False,21,52528
2020-01-24,57,Friday,January,2020,False,57,52585
2020-01-25,10,Saturday,January,2020,True,10,52595
2020-01-26,0,Sunday,January,2020,True,0,52595
2020-01-27,31,Monday,January,2020,False,31,52626
2020-01-28,20,Tuesday,January,2020,False,20,52646
2020-01-29,25,Wednesday,January,2020,False,25,52671
2020-01-30,30,Thursday,January,2020,False,30,52701
2020-01-31,50,Friday,January,2020,False,50,52751
2020-02-01,12,Saturday,February,2020,True,12,52763
2020-02-02,3,Sunday,February,2020,True,3,52766
2020-02-03,24,Monday,February,2020,False,24,52790
2020-02-04,24,Tuesday,February,2020,False,24,52814
2020-02-05,26,Wednesday,February,2020,False,26,52840
2020-02-06,42,Thursday,February,2020,False,42,52882
2020-02-07,63,Friday,February,2020,False,63,52945
2020-02-08,6,Saturday,February,2020,True,6,52951
2020-02-09,0,Sunday,February,2020,True,0,52951
2020-02-10,38,Monday,February,2020,False,38,52989
2020-02-11,21,Tuesday,February,2020,False,21,53010
2020-02-12,19,Wednesday,February,2020,False,19,53029
2020-02-13,32,Thursday,February,2020,False,32,53061
2020-02-14,37,Friday,February,2020,False,37,53098
2020-02-15,9,Saturday,February,2020,True,9,53107
2020-02-16,0,Sunday,February,2020,True,0,53107
2020-02-17,26,Monday,February,2020,False,26,53133
2020-02-18,30,Tuesday,February,2020,False,30,53163
2020-02-19,35,Wednesday,February,2020,False,35,53198
2020-02-20,32,Thursday,February,2020,False,32,53230
2020-02-21,42,Friday,February,2020,False,42,53272
2020-02-22,9,Saturday,February,2020,True,9,53281
2020-02-23,5,Sunday,February,2020,True,5,53286
2020-02-24,37,Monday,February,2020,False,37,53323
2020-02-25,40,Tuesday,February,2020,False,40,53363
2020-02-26,18,Wednesday,February,2020,False,18,53381
2020-02-27,44,Thursday,February,2020,False,44,53425
2020-02-28,54,Friday,February,2020,False,54,53479
2020-02-29,2,Saturday,February,2020,True,2,53481
2020-03-01,2,Sunday,March,2020,True,2,53483
2020-03-02,25,Monday,March,2020,False,25,53508
2020-03-03,31,Tuesday,March,2020,False,31,53539
2020-03-04,56,Wednesday,March,2020,False,56,53595
2020-03-05,51,Thursday,March,2020,False,51,53646
2020-03-06,32,Friday,March,2020,False,32,53678
2020-03-07,10,Saturday,March,2020,True,10,53688
2020-03-08,10,Sunday,March,2020,True,10,53698
2020-03-09,30,Monday,March,2020,False,30,53728
2020-03-10,43,Tuesday,March,2020,False,43,53771
2020-03-11,25,Wednesday,March,2020,False,25,53796
2020-03-12,62,Thursday,March,2020,False,62,53858
2020-03-13,40,Friday,March,2020,False,40,53898
2020-03-14,2,Saturday,March,2020,True,2,53900
2020-03-15,10,Sunday,March,2020,True,10,53910
2020-03-16,40,Monday,March,2020,False,40,53950
2020-03-17,38,Tuesday,March,2020,False,38,53988
2020-03-18,33,Wednesday,March,2020,False,33,54021
2020-03-19,52,Thursday,March,2020,False,52,54073
2020-03-20,26,Friday,March,2020,False,26,54099
2020-03-21,2,Saturday,March,2020,True,2,54101
2020-03-22,2,Sunday,March,2020,True,2,54103
2020-03-23,54,Monday,March,2020,False,54,54157
2020-03-24,38,Tuesday,March,2020,False,38,54195
2020-03-25,31,Wednesday,March,2020,False,31,54226
2020-03-26,74,Thursday,March,2020,False,74,54300
2020-03-27,25,Friday,March,2020,False,25,54325
2020-03-28,5,Saturday,March,2020,True,5,54330
2020-03-29,1,Sunday,March,2020,True,1,54331
2020-03-30,17,Monday,March,2020,False,17,54348
2020-03-31,80,Tuesday,March,2020,False,80,54428
2020-04-01,29,Wednesday,April,2020,False,29,54457
2020-04-02,15,Thursday,April,2020,False,15,54472
2020-04-03,14,Friday,April,2020,False,14,54486
2020-04-04,31,Saturday,April,2020,True,31,54517
2020-04-05,3,Sunday,April,2020,True,3,54520
2020-04-06,34,Monday,April,2020,False,34,54554
2020-04-07,24,Tuesday,April,2020,False,24,54578
2020-04-08,33,Wednesday,April,2020,False,33,54611
2020-04-09,52,Thursday,April,2020,False,52,54663
2020-04-10,3,Friday,April,2020,False,3,54666
2020-04-11,2,Saturday,April,2020,True,2,54668
2020-04-12,5,Sunday,April,2020,True,5,54673
2020-04-13,6,Monday,April,2020,False,6,54679
2020-04-14,32,Tuesday,April,2020,False,32,54711
2020-04-15,46,Wednesday,April,2020,False,46,54757
2020-04-16,57,Thursday,April,2020,False,57,54814
2020-04-17,45,Friday,April,2020,False,45,54859
2020-04-18,3,Saturday,April,2020,True,3,54862
2020-04-19,3,Sunday,April,2020,True,3,54865
2020-04-20,22,Monday,April,2020,False,22,54887
2020-04-21,40,Tuesday,April,2020,False,40,54927
2020-04-22,26,Wednesday,April,2020,False,26,54953
2020-04-23,67,Thursday,April,2020,False,67,55020
2020-04-24,33,Friday,April,2020,False,33,55053
2020-04-25,6,Saturday,April,2020,True,6,55059
2020-04-26,7,Sunday,April,2020,True,7,55066
2020-04-27,18,Monday,April,2020,False,18,55084
2020-04-28,45,Tuesday,April,2020,False,45,55129
2020-04-29,33,Wednesday,April,2020,False,33,55162
2020-04-30,67,Thursday,April,2020,False,67,55229
2020-05-01,19,Friday,May,2020,False,19,55248
2020-05-02,7,Saturday,May,2020,True,7,55255
2020-05-03,6,Sunday,May,2020,True,6,55261
2020-05-04,32,Monday,May,2020,False,32,55293
2020-05-05,37,Tuesday,May,2020,False,37,55330
2020-05-06,41,Wednesday,May,2020,False,41,55371
2020-05-07,41,Thursday,May,2020,False,41,55412
2020-05-08,71,Friday,May,2020,False,71,55483
2020-05-09,4,Saturday,May,2020,True,4,55487
2020-05-10,2,Sunday,May,2020,True,2,55489
2020-05-11,40,Monday,May,2020,False,40,55529
2020-05-12,56,Tuesday,May,2020,False,56,55585
2020-05-13,50,Wednesday,May,2020,False,50,55635
2020-05-14,76,Thursday,May,2020,False,76,55711
2020-05-15,60,Friday,May,2020,False,60,55771
2020-05-16,6,Saturday,May,2020,True,6,55777
2020-05-17,10,Sunday,May,2020,True,10,55787
2020-05-18,74,Monday,May,2020,False,74,55861
2020-05-19,33,Tuesday,May,2020,False,33,55894
2020-05-20,45,Wednesday,May,2020,False,45,55939
2020-05-21,57,Thursday,May,2020,False,57,55996
2020-05-22,45,Friday,May,2020,False,45,56041
2020-05-23,12,Saturday,May,2020,True,12,56053
2020-05-24,6,Sunday,May,2020,True,6,56059
2020-05-25,27,Monday,May,2020,False,27,56086
2020-05-26,33,Tuesday,May,2020,False,33,56119
2020-05-27,38,Wednesday,May,2020,False,38,56157
2020-05-28,70,Thursday,May,2020,False,70,56227
2020-05-29,37,Friday,May,2020,False,37,56264
2020-05-30,9,Saturday,May,2020,True,9,56273
2020-05-31,2,Sunday,May,2020,True,2,56275
2020-06-01,51,Monday,June,2020,False,51,56326
2020-06-02,39,Tuesday,June,2020,False,39,56365
2020-06-03,24,Wednesday,June,2020,False,24,56389
2020-06-04,34,Thursday,June,2020,False,34,56423
2020-06-05,84,Friday,June,2020,False,84,56507
2020-06-06,15,Saturday,June,2020,True,15,56522
2020-06-07,6,Sunday,June,2020,True,6,56528
2020-06-08,54,Monday,June,2020,False,54,56582
2020-06-09,55,Tuesday,June,2020,False,55,56637
2020-06-10,61,Wednesday,June,2020,False,61,56698
2020-06-11,100,Thursday,June,2020,False,100,56798
2020-06-12,14,Friday,June,2020,False,14,56812
2020-06-13,1,Saturday,June,2020,True,1,56813
2020-06-14,23,Sunday,June,2020,True,23,56836
2020-06-15,32,Monday,June,2020,False,32,56868
2020-06-16,48,Tuesday,June,2020,False,48,56916
2020-06-17,52,Wednesday,June,2020,False,52,56968
2020-06-18,63,Thursday,June,2020,False,63,57031
2020-06-19,42,Friday,June,2020,False,42,57073
2020-06-20,10,Saturday,June,2020,True,10,57083
2020-06-21,12,Sunday,June,2020,True,12,57095
2020-06-22,55,Monday,June,2020,False,55,57150
2020-06-23,53,Tuesday,June,2020,False,53,57203
2020-06-24,17,Wednesday,June,2020,False,17,57220
2020-06-25,51,Thursday,June,2020,False,51,57271
2020-06-26,35,Friday,June,2020,False,35,57306
2020-06-27,8,Saturday,June,2020,True,8,57314
2020-06-28,14,Sunday,June,2020,True,14,57328
2020-06-29,36,Monday,June,2020,False,36,57364
2020-06-30,38,Tuesday,June,2020,False,38,57402
2020-07-01,61,Wednesday,July,2020,False,61,57463
2020-07-02,86,Thursday,July,2020,False,86,57549
2020-07-03,62,Friday,July,2020,False,62,57611
2020-07-04,16,Saturday,July,2020,True,16,57627
2020-07-05,7,Sunday,July,2020,True,7,57634
2020-07-06,51,Monday,July,2020,False,51,57685
2020-07-07,21,Tuesday,July,2020,False,21,57706
2020-07-08,45,Wednesday,July,2020,False,45,57751
2020-07-09,100,Thursday,July,2020,False,100,57851
2020-07-10,55,Friday,July,2020,False,55,57906
2020-07-11,8,Saturday,July,2020,True,8,57914
2020-07-12,8,Sunday,July,2020,True,8,57922
2020-07-13,57,Monday,July,2020,False,57,57979
2020-07-14,49,Tuesday,July,2020,False,49,58028
2020-07-15,72,Wednesday,July,2020,False,72,58100
2020-07-16,70,Thursday,July,2020,False,70,58170
2020-07-17,70,Friday,July,2020,False,70,58240
2020-07-18,16,Saturday,July,2020,True,16,58256
2020-07-19,14,Sunday,July,2020,True,14,58270
2020-07-20,43,Monday,July,2020,False,43,58313
2020-07-21,67,Tuesday,July,2020,False,67,58380
2020-07-22,41,Wednesday,July,2020,False,41,58421
2020-07-23,73,Thursday,July,2020,False,73,58494
2020-07-24,79,Friday,July,2020,False,79,58573
2020-07-25,12,Saturday,July,2020,True,12,58585
2020-07-26,1,Sunday,July,2020,True,1,58586
2020-07-27,38,Monday,July,2020,False,38,58624
2020-07-28,48,Tuesday,July,2020,False,48,58672
2020-07-29,50,Wednesday,July,2020,False,50,58722
2020-07-30,61,Thursday,July,2020,False,61,58783
2020-07-31,52,Friday,July,2020,False,52,58835
2020-08-01,25,Saturday,August,2020,True,25,58860
2020-08-02,5,Sunday,August,2020,True,5,58865
2020-08-03,30,Monday,August,2020,False,30,58895
2020-08-04,31,Tuesday,August,2020,False,31,58926
2020-08-05,56,Wednesday,August,2020,False,56,58982
2020-08-06,87,Thursday,August,2020,False,87,59069
2020-08-07,43,Friday,August,2020,False,43,59112
2020-08-08,25,Saturday,August,2020,True,25,59137
2020-08-09,15,Sunday,August,2020,True,15,59152
2020-08-10,50,Monday,August,2020,False,50,59202
2020-08-11,40,Tuesday,August,2020,False,40,59242
2020-08-12,77,Wednesday,August,2020,False,77,59319
2020-08-13,34,Thursday,August,2020,False,34,59353
2020-08-14,83,Friday,August,2020,False,83,59436
2020-08-15,13,Saturday,August,2020,True,13,59449
2020-08-16,15,Sunday,August,2020,True,15,59464
2020-08-17,61,Monday,August,2020,False,61,59525
2020-08-18,45,Tuesday,August,2020,False,45,59570
2020-08-19,42,Wednesday,August,2020,False,42,59612
2020-08-20,65,Thursday,August,2020,False,65,59677
2020-08-21,68,Friday,August,2020,False,68,59745
2020-08-22,27,Saturday,August,2020,True,27,59772
2020-08-23,12,Sunday,August,2020,True,12,59784
2020-08-24,54,Monday,August,2020,False,54,59838
2020-08-25,28,Tuesday,August,2020,False,28,59866
2020-08-26,78,Wednesday,August,2020,False,78,59944
2020-08-27,95,Thursday,August,2020,False,95,60039
2020-08-28,40,Friday,August,2020,False,40,60079
2020-08-29,0,Saturday,August,2020,True,0,60079
2020-08-30,18,Sunday,August,2020,True,18,60097
2020-08-31,31,Monday,August,2020,False,31,60128
2020-09-01,34,Tuesday,September,2020,False,34,60162
2020-09-02,66,Wednesday,September,2020,False,66,60228
2020-09-03,68,Thursday,September,2020,False,68,60296
2020-09-04,75,Friday,September,2020,False,75,60371
2020-09-05,14,Saturday,September,2020,True,14,60385
2020-09-06,11,Sunday,September,2020,True,11,60396
2020-09-07,82,Monday,September,2020,False,82,60478
2020-09-08,57,Tuesday,September,2020,False,57,60535
2020-09-09,52,Wednesday,September,2020,False,52,60587
2020-09-10,68,Thursday,September,2020,False,68,60655
2020-09-11,76,Friday,September,2020,False,76,60731
2020-09-12,4,Saturday,September,2020,True,4,60735
2020-09-13,14,Sunday,September,2020,True,14,60749
2020-09-14,40,Monday,September,2020,False,40,60789
2020-09-15,32,Tuesday,September,2020,False,32,60821
2020-09-16,67,Wednesday,September,2020,False,67,60888
2020-09-17,55,Thursday,September,2020,False,55,60943
2020-09-18,76,Friday,September,2020,False,76,61019
2020-09-19,14,Saturday,September,2020,True,14,61033
2020-09-20,8,Sunday,September,2020,True,8,61041
2020-09-21,63,Monday,September,2020,False,63,61104
2020-09-22,43,Tuesday,September,2020,False,43,61147
2020-09-23,44,Wednesday,September,2020,False,44,61191
2020-09-24,76,Thursday,September,2020,False,76,61267
2020-09-25,64,Friday,September,2020,False,64,61331
2020-09-26,14,Saturday,September,2020,True,14,61345
2020-09-27,21,Sunday,September,2020,True,21,61366
2020-09-28,39,Monday,September,2020,False,39,61405
2020-09-29,49,Tuesday,September,2020,False,49,61454
2020-09-30,82,Wednesday,September,2020,False,82,61536
2020-10-01,49,Thursday,October,2020,False,49,61585
2020-10-02,66,Friday,October,2020,False,66,61651
2020-10-03,22,Saturday,October,2020,True,22,61673
2020-10-04,21,Sunday,October,2020,True,21,61694
2020-10-05,31,Monday,October,2020,False,31,61725
2020-10-06,31,Tuesday,October,2020,False,31,61756
2020-10-07,81,Wednesday,October,2020,False,81,61837
2020-10-08,56,Thursday,October,2020,False,56,61893
2020-10-09,82,Friday,October,2020,False,82,61975
2020-10-10,24,Saturday,October,2020,True,24,61999
2020-10-11,33,Sunday,October,2020,True,33,62032
2020-10-12,61,Monday,October,2020,False,61,62093
2020-10-13,41,Tuesday,October,2020,False,41,62134
2020-10-14,60,Wednesday,October,2020,False,60,62194
2020-10-15,25,Thursday,October,2020,False,25,62219
2020-10-16,74,Friday,October,2020,False,74,62293
2020-10-17,16,Saturday,October,2020,True,16,62309
2020-10-18,31,Sunday,October,2020,True,31,62340
2020-10-19,47,Monday,October,2020,False,47,62387
2020-10-20,58,Tuesday,October,2020,False,58,62445
2020-10-21,63,Wednesday,October,2020,False,63,62508
2020-10-22,56,Thursday,October,2020,False,56,62564
2020-10-23,76,Friday,October,2020,False,76,62640
2020-10-24,0,Saturday,October,2020,True,0,62640
2020-10-25,63,Sunday,October,2020,True,63,62703
2020-10-26,45,Monday,October,2020,False,45,62748
2020-10-27,33,Tuesday,October,2020,False,33,62781
2020-10-28,143,Wednesday,October,2020,False,143,62924
2020-10-29,61,Thursday,October,2020,False,61,62985
2020-10-30,124,Friday,October,2020,False,124,63109
2020-10-31,22,Saturday,October,2020,True,22,63131
2020-11-01,1,Sunday,November,2020,True,1,63132
2020-11-02,66,Monday,November,2020,False,66,63198
2020-11-03,74,Tuesday,November,2020,False,74,63272
2020-11-04,76,Wednesday,November,2020,False,76,63348
2020-11-05,86,Thursday,November,2020,False,86,63434
2020-11-06,97,Friday,November,2020,False,97,63531
2020-11-07,34,Saturday,November,2020,True,34,63565
2020-11-08,17,Sunday,November,2020,True,17,63582
2020-11-09,68,Monday,November,2020,False,68,63650
2020-11-10,48,Tuesday,November,2020,False,48,63698
2020-11-11,98,Wednesday,November,2020,False,98,63796
2020-11-12,64,Thursday,November,2020,False,64,63860
2020-11-13,94,Friday,November,2020,False,94,63954
2020-11-14,10,Saturday,November,2020,True,10,63964
2020-11-15,38,Sunday,November,2020,True,38,64002
2020-11-16,75,Monday,November,2020,False,75,64077
2020-11-17,70,Tuesday,November,2020,False,70,64147
2020-11-18,36,Wednesday,November,2020,False,36,64183
2020-11-19,101,Thursday,November,2020,False,101,64284
2020-11-20,76,Friday,November,2020,False,76,64360
2020-11-21,1,Saturday,November,2020,True,1,64361
2020-11-22,51,Sunday,November,2020,True,51,64412
2020-11-23,99,Monday,November,2020,False,99,64511
2020-11-24,50,Tuesday,November,2020,False,50,64561
2020-11-25,50,Wednesday,November,2020,False,50,64611
2020-11-26,97,Thursday,November,2020,False,97,64708
2020-11-27,114,Friday,November,2020,False,114,64822
2020-11-28,30,Saturday,November,2020,True,30,64852
2020-11-29,47,Sunday,November,2020,True,47,64899
2020-11-30,68,Monday,November,2020,False,68,64967
2020-12-01,54,Tuesday,December,2020,False,54,65021
2020-12-02,41,Wednesday,December,2020,False,41,65062
2020-12-03,101,Thursday,December,2020,False,101,65163
2020-12-04,61,Friday,December,2020,False,61,65224
2020-12-05,13,Saturday,December,2020,True,13,65237
2020-12-06,31,Sunday,December,2020,True,31,65268
2020-12-07,68,Monday,December,2020,False,68,65336
2020-12-08,64,Tuesday,December,2020,False,64,65400
2020-12-09,44,Wednesday,December,2020,False,44,65444
2020-12-10,74,Thursday,December,2020,False,74,65518
2020-12-11,129,Friday,December,2020,False,129,65647
2020-12-12,25,Saturday,December,2020,True,25,65672
2020-12-13,2,Sunday,December,2020,True,2,65674
2020-12-14,89,Monday,December,2020,False,89,65763
2020-12-15,20,Tuesday,December,2020,False,20,65783
2020-12-16,77,Wednesday,December,2020,False,77,65860
2020-12-17,124,Thursday,December,2020,False,124,65984
2020-12-18,91,Friday,December,2020,False,91,66075
2020-12-19,42,Saturday,December,2020,True,42,66117
2020-12-20,0,Sunday,December,2020,True,0,66117
2020-12-21,91,Monday,December,2020,False,91,66208
2020-12-22,38,Tuesday,December,2020,False,38,66246
2020-12-23,137,Wednesday,December,2020,False,137,66383
2020-12-24,83,Thursday,December,2020,False,83,66466
2020-12-25,40,Friday,December,2020,False,40,66506
2020-12-26,3,Saturday,December,2020,True,3,66509
2020-12-27,0,Sunday,December,2020,True,0,66509
2020-12-28,60,Monday,December,2020,False,60,66569
2020-12-29,71,Tuesday,December,2020,False,71,66640
2020-12-30,63,Wednesday,December,2020,False,63,66703
2020-12-31,180,Thursday,December,2020,False,180,66883
2021-01-01,62,Friday,January,2021,False,62,66945
2021-01-02,25,Saturday,January,2021,True,25,66970
2021-01-03,,Sunday,January,2021,True,0,66970
2021-01-04,50,Monday,January,2021,False,50,67020
2021-01-05,51,Tuesday,January,2021,False,51,67071
2021-01-06,91,Wednesday,January,2021,False,91,67162
2021-01-07,78,Thursday,January,2021,False,78,67240
2021-01-08,122,Friday,January,2021,False,122,67362
2021-01-09,25,Saturday,January,2021,True,25,67387
2021-01-10,18,Sunday,January,2021,True,18,67405
2021-01-11,50,Monday,January,2021,False,50,67455
2021-01-12,40,Tuesday,January,2021,False,40,67495
2021-01-13,100,Wednesday,January,2021,False,100,67595
2021-01-14,112,Thursday,January,2021,False,112,67707
2021-01-15,146,Friday,January,2021,False,146,67853
2021-01-16,12,Saturday,January,2021,True,12,67865
2021-01-17,18,Sunday,January,2021,True,18,67883
2021-01-18,108,Monday,January,2021,False,108,67991
2021-01-19,96,Tuesday,January,2021,False,96,68087
2021-01-20,99,Wednesday,January,2021,False,99,68186
2021-01-21,115,Thursday,January,2021,False,115,68301
2021-01-22,105,Friday,January,2021,False,105,68406
2021-01-23,12,Saturday,January,2021,True,12,68418
2021-01-24,0,Sunday,January,2021,True,0,68418
2021-01-25,119,Monday,January,2021,False,119,68537
2021-01-26,112,Tuesday,January,2021,False,112,68649
2021-01-27,92,Wednesday,January,2021,False,92,68741
2021-01-28,85,Thursday,January,2021,False,85,68826
2021-01-29,3,Friday,January,2021,False,3,68829
2021-01-30,6,Saturday,January,2021,True,6,68835
2021-01-31,1,Sunday,January,2021,True,1,68836
2021-02-01,70,Monday,February,2021,False,70,68906
2021-02-02,82,Tuesday,February,2021,False,82,68988
2021-02-03,111,Wednesday,February,2021,False,111,69099
2021-02-04,95,Thursday,February,2021,False,95,69194
2021-02-05,101,Friday,February,2021,False,101,69295
2021-02-06,0,Saturday,February,2021,True,0,69295
2021-02-07,0,Sunday,February,2021,True,0,69295
2021-02-08,84,Monday,February,2021,False,84,69379
2021-02-09,84,Tuesday,February,2021,False,84,69463
2021-02-10,100,Wednesday,February,2021,False,100,69563
2021-02-11,77,Thursday,February,2021,False,77,69640
2021-02-12,99,Friday,February,2021,False,99,69739
2021-02-13,0,Saturday,February,2021,True,0,69739
2021-02-14,0,Sunday,February,2021,True,0,69739
2021-02-15,56,Monday,February,2021,False,56,69795
2021-02-16,117,Tuesday,February,2021,False,117,69912
2021-02-17,128,Wednesday,February,2021,False,128,70040
2021-02-18,125,Thursday,February,2021,False,125,70165
2021-02-19,45,Friday,February,2021,False,45,70210
2021-02-20,0,Saturday,February,2021,True,0,70210
2021-02-21,2,Sunday,February,2021,True,2,70212
2021-02-22,66,Monday,February,2021,False,66,70278
2021-02-23,79,Tuesday,February,2021,False,79,70357
2021-02-24,140,Wednesday,February,2021,False,140,70497
2021-02-25,156,Thursday,February,2021,False,156,70653
2021-02-26,24,Friday,February,2021,False,24,70677
2021-02-27,13,Saturday,February,2021,True,13,70690
2021-02-28,,Sunday,February,2021,True,0,70690
2021-03-01,124,Monday,March,2021,False,124,70814
2021-03-02,121,Tuesday,March,2021,False,121,70935
2021-03-03,54,Wednesday,March,2021,False,54,70989
2021-03-04,133,Thursday,March,2021,False,133,71122
2021-03-05,46,Friday,March,2021,False,46,71168
2021-03-06,0,Saturday,March,2021,True,0,71168
2021-03-07,0,Sunday,March,2021,True,0,71168
2021-03-08,97,Monday,March,2021,False,97,71265
2021-03-09,100,Tuesday,March,2021,False,100,71365
2021-03-10,135,Wednesday,March,2021,False,135,71500
2021-03-11,104,Thursday,March,2021,False,104,71604
2021-03-12,47,Friday,March,2021,False,47,71651
2021-03-13,0,Saturday,March,2021,True,0,71651
2021-03-14,0,Sunday,March,2021,True,0,71651
2021-03-15,104,Monday,March,2021,False,104,71755
2021-03-16,181,Tuesday,March,2021,False,181,71936
2021-03-17,111,Wednesday,March,2021,False,111,72047
2021-03-18,60,Thursday,March,2021,False,60,72107
2021-03-19,5,Friday,March,2021,False,5,72112
2021-03-20,1,Saturday,March,2021,True,1,72113
2021-03-21,0,Sunday,March,2021,True,0,72113
2021-03-22,105,Monday,March,2021,False,105,72218
2021-03-23,198,Tuesday,March,2021,False,198,72416
2021-03-24,79,Wednesday,March,2021,False,79,72495
2021-03-25,66,Thursday,March,2021,False,66,72561
2021-03-26,3,Friday,March,2021,False,3,72564
2021-03-27,1,Saturday,March,2021,True,1,72565
2021-03-28,0,Sunday,March,2021,True,0,72565
2021-03-29,160,Monday,March,2021,False,160,72725
2021-03-30,166,Tuesday,March,2021,False,166,72891
2021-03-31,133,Wednesday,March,2021,False,133,73024
2021-04-01,15,Thursday,April,2021,False,15,73039
2021-04-02,7,Friday,April,2021,False,7,73046
2021-04-03,0,Saturday,April,2021,True,0,73046
2021-04-04,1,Sunday,April,2021,True,1,73047
2021-04-05,57,Monday,April,2021,False,57,73104
2021-04-06,146,Tuesday,April,2021,False,146,73250
2021-04-07,83,Wednesday,April,2021,False,83,73333
2021-04-08,127,Thursday,April,2021,False,127,73460
2021-04-09,52,Friday,April,2021,False,52,73512
2021-04-10,6,Saturday,April,2021,True,6,73518
2021-04-11,0,Sunday,April,2021,True,0,73518
2021-04-12,129,Monday,April,2021,False,129,73647
2021-04-13,117,Tuesday,April,2021,False,117,73764
2021-04-14,154,Wednesday,April,2021,False,154,73918
2021-04-15,41,Thursday,April,2021,False,41,73959
2021-04-16,35,Friday,April,2021,False,35,73994
2021-04-17,0,Saturday,April,2021,True,0,73994
2021-04-18,0,Sunday,April,2021,True,0,73994
2021-04-19,122,Monday,April,2021,False,122,74116
2021-04-20,95,Tuesday,April,2021,False,95,74211
2021-04-21,105,Wednesday,April,2021,False,105,74316
2021-04-22,18,Thursday,April,2021,False,18,74334
2021-04-23,18,Friday,April,2021,False,18,74352
2021-04-24,0,Saturday,April,2021,True,0,74352
2021-04-25,0,Sunday,April,2021,True,0,74352
2021-04-26,137,Monday,April,2021,False,137,74489
2021-04-27,152,Tuesday,April,2021,False,152,74641
2021-04-28,130,Wednesday,April,2021,False,130,74771
2021-04-29,33,Thursday,April,2021,False,33,74804
2021-04-30,14,Friday,April,2021,False,14,74818
2021-05-01,0,Saturday,May,2021,True,0,74818
2021-05-02,24,Sunday,May,2021,True,24,74842
2021-05-03,74,Monday,May,2021,False,74,74916
2021-05-04,140,Tuesday,May,2021,False,140,75056
2021-05-05,168,Wednesday,May,2021,False,168,75224
2021-05-06,39,Thursday,May,2021,False,39,75263
2021-05-07,31,Friday,May,2021,False,31,75294
2021-05-08,0,Saturday,May,2021,True,0,75294
2021-05-09,0,Sunday,May,2021,True,0,75294
2021-05-10,123,Monday,May,2021,False,123,75417
2021-05-11,155,Tuesday,May,2021,False,155,75572
2021-05-12,120,Wednesday,May,2021,False,120,75692
2021-05-13,65,Thursday,May,2021,False,65,75757
2021-05-14,18,Friday,May,2021,False,18,75775
2021-05-15,0,Saturday,May,2021,True,0,75775
2021-05-16,1,Sunday,May,2021,True,1,75776
2021-05-17,144,Monday,May,2021,False,144,75920
2021-05-18,167,Tuesday,May,2021,False,167,76087
2021-05-19,120,Wednesday,May,2021,False,120,76207
2021-05-20,35,Thursday,May,2021,False,35,76242
2021-05-21,7,Friday,May,2021,False,7,76249
2021-05-22,0,Saturday,May,2021,True,0,76249
2021-05-23,0,Sunday,May,2021,True,0,76249
2021-05-24,185,Monday,May,2021,False,185,76434
2021-05-25,184,Tuesday,May,2021,False,184,76618
2021-05-26,63,Wednesday,May,2021,False,63,76681
2021-05-27,41,Thursday,May,2021,False,41,76722
2021-05-28,10,Friday,May,2021,False,10,76732
2021-05-29,0,Saturday,May,2021,True,0,76732
2021-05-30,0,Sunday,May,2021,True,0,76732
2021-05-31,8,Monday,May,2021,False,8,76740
2021-06-01,101,Tuesday,June,2021,False,101,76841
2021-06-02,183,Wednesday,June,2021,False,183,77024
2021-06-03,140,Thursday,June,2021,False,140,77164
2021-06-04,46,Friday,June,2021,False,46,77210
2021-06-05,1,Saturday,June,2021,True,1,77211
2021-06-06,0,Sunday,June,2021,True,0,77211
2021-06-07,117,Monday,June,2021,False,117,77328
2021-06-08,149,Tuesday,June,2021,False,149,77477
2021-06-09,121,Wednesday,June,2021,False,121,77598
2021-06-10,89,Thursday,June,2021,False,89,77687
2021-06-11,6,Friday,June,2021,False,6,77693
2021-06-12,0,Saturday,June,2021,True,0,77693
2021-06-13,0,Sunday,June,2021,True,0,77693
2021-06-14,96,Monday,June,2021,False,96,77789
2021-06-15,118,Tuesday,June,2021,False,118,77907
2021-06-16,135,Wednesday,June,2021,False,135,78042
2021-06-17,104,Thursday,June,2021,False,104,78146
2021-06-18,29,Friday,June,2021,False,29,78175
2021-06-19,0,Saturday,June,2021,True,0,78175
2021-06-20,1,Sunday,June,2021,True,1,78176
2021-06-21,150,Monday,June,2021,False,150,78326
2021-06-22,137,Tuesday,June,2021,False,137,78463
2021-06-23,107,Wednesday,June,2021,False,107,78570
2021-06-24,57,Thursday,June,2021,False,57,78627
2021-06-25,35,Friday,June,2021,False,35,78662
2021-06-26,0,Saturday,June,2021,True,0,78662
2021-06-27,0,Sunday,June,2021,True,0,78662
2021-06-28,150,Monday,June,2021,False,150,78812
2021-06-29,108,Tuesday,June,2021,False,108,78920
2021-06-30,187,Wednesday,June,2021,False,187,79107
2021-07-01,24,Thursday,July,2021,False,24,79131
2021-07-02,22,Friday,July,2021,False,22,79153
2021-07-03,1,Saturday,July,2021,True,1,79154
2021-07-04,0,Sunday,July,2021,True,0,79154
2021-07-05,151,Monday,July,2021,False,151,79305
2021-07-06,130,Tuesday,July,2021,False,130,79435
2021-07-07,72,Wednesday,July,2021,False,72,79507
2021-07-08,70,Thursday,July,2021,False,70,79577
2021-07-09,49,Friday,July,2021,False,49,79626
2021-07-10,1,Saturday,July,2021,True,1,79627
2021-07-11,0,Sunday,July,2021,True,0,79627
2021-07-12,162,Monday,July,2021,False,162,79789
2021-07-13,113,Tuesday,July,2021,False,113,79902
2021-07-14,74,Wednesday,July,2021,False,74,79976
2021-07-15,93,Thursday,July,2021,False,93,80069
2021-07-16,50,Friday,July,2021,False,50,80119
2021-07-17,10,Saturday,July,2021,True,10,80129
2021-07-18,0,Sunday,July,2021,True,0,80129
2021-07-19,150,Monday,July,2021,False,150,80279
2021-07-20,149,Tuesday,July,2021,False,149,80428
2021-07-21,95,Wednesday,July,2021,False,95,80523
2021-07-22,84,Thursday,July,2021,False,84,80607
2021-07-23,23,Friday,July,2021,False,23,80630
2021-07-24,0,Saturday,July,2021,True,0,80630
2021-07-25,0,Sunday,July,2021,True,0,80630
2021-07-26,139,Monday,July,2021,False,139,80769
2021-07-27,97,Tuesday,July,2021,False,97,80866
2021-07-28,114,Wednesday,July,2021,False,114,80980
2021-07-29,117,Thursday,July,2021,False,117,81097
2021-07-30,16,Friday,July,2021,False,16,81113
2021-07-31,5,Saturday,July,2021,True,5,81118
2021-08-01,0,Sunday,August,2021,True,0,81118
2021-08-02,98,Monday,August,2021,False,98,81216
2021-08-03,100,Tuesday,August,2021,False,100,81316
2021-08-04,97,Wednesday,August,2021,False,97,81413
2021-08-05,119,Thursday,August,2021,False,119,81532
2021-08-06,94,Friday,August,2021,False,94,81626
2021-08-07,0,Saturday,August,2021,True,0,81626
2021-08-08,0,Sunday,August,2021,True,0,81626
2021-08-09,70,Monday,August,2021,False,70,81696
2021-08-10,80,Tuesday,August,2021,False,80,81776
2021-08-11,126,Wednesday,August,2021,False,126,81902
2021-08-12,136,Thursday,August,2021,False,136,82038
2021-08-13,55,Friday,August,2021,False,55,82093
2021-08-14,10,Saturday,August,2021,True,10,82103
2021-08-15,0,Sunday,August,2021,True,0,82103
2021-08-16,36,Monday,August,2021,False,36,82139
2021-08-17,130,Tuesday,August,2021,False,130,82269
2021-08-18,196,Wednesday,August,2021,False,196,82465
2021-08-19,100,Thursday,August,2021,False,100,82565
2021-08-20,26,Friday,August,2021,False,26,82591
2021-08-21,0,Saturday,August,2021,True,0,82591
2021-08-22,0,Sunday,August,2021,True,0,82591
2021-08-23,58,Monday,August,2021,False,58,82649
2021-08-24,142,Tuesday,August,2021,False,142,82791
2021-08-25,174,Wednesday,August,2021,False,174,82965
2021-08-26,90,Thursday,August,2021,False,90,83055
2021-08-27,30,Friday,August,2021,False,30,83085
2021-08-28,4,Saturday,August,2021,True,4,83089
2021-08-29,0,Sunday,August,2021,True,0,83089
2021-08-30,57,Monday,August,2021,False,57,83146
2021-08-31,160,Tuesday,August,2021,False,160,83306
2021-09-01,127,Wednesday,September,2021,False,127,83433
2021-09-02,103,Thursday,September,2021,False,103,83536
2021-09-03,51,Friday,September,2021,False,51,83587
2021-09-04,0,Saturday,September,2021,True,0,83587
2021-09-05,0,Sunday,September,2021,True,0,83587
2021-09-06,59,Monday,September,2021,False,59,83646
2021-09-07,130,Tuesday,September,2021,False,130,83776
2021-09-08,190,Wednesday,September,2021,False,190,83966
2021-09-09,93,Thursday,September,2021,False,93,84059
2021-09-10,27,Friday,September,2021,False,27,84086
2021-09-11,1,Saturday,September,2021,True,1,84087
2021-09-12,0,Sunday,September,2021,True,0,84087
2021-09-13,54,Monday,September,2021,False,54,84141
2021-09-14,69,Tuesday,September,2021,False,69,84210
2021-09-15,173,Wednesday,September,2021,False,173,84383
2021-09-16,116,Thursday,September,2021,False,116,84499
2021-09-17,85,Friday,September,2021,False,85,84584
2021-09-18,1,Saturday,September,2021,True,1,84585
2021-09-19,0,Sunday,September,2021,True,0,84585
2021-09-20,76,Monday,September,2021,False,76,84661
2021-09-21,155,Tuesday,September,2021,False,155,84816
2021-09-22,150,Wednesday,September,2021,False,150,84966
2021-09-23,88,Thursday,September,2021,False,88,85054
2021-09-24,36,Friday,September,2021,False,36,85090
2021-09-25,2,Saturday,September,2021,True,2,85092
2021-09-26,1,Sunday,September,2021,True,1,85093
2021-09-27,84,Monday,September,2021,False,84,85177
2021-09-28,141,Tuesday,September,2021,False,141,85318
2021-09-29,153,Wednesday,September,2021,False,153,85471
2021-09-30,112,Thursday,September,2021,False,112,85583
2021-10-01,7,Friday,October,2021,False,7,85590
2021-10-02,0,Saturday,October,2021,True,0,85590
2021-10-03,0,Sunday,October,2021,True,0,85590
2021-10-04,56,Monday,October,2021,False,56,85646
2021-10-05,167,Tuesday,October,2021,False,167,85813
2021-10-06,135,Wednesday,October,2021,False,135,85948
2021-10-07,178,Thursday,October,2021,False,178,86126
2021-10-08,47,Friday,October,2021,False,47,86173
2021-10-09,1,Saturday,October,2021,True,1,86174
2021-10-10,1,Sunday,October,2021,True,1,86175
2021-10-11,66,Monday,October,2021,False,66,86241
2021-10-12,185,Tuesday,October,2021,False,185,86426
2021-10-13,143,Wednesday,October,2021,False,143,86569
2021-10-14,63,Thursday,October,2021,False,63,86632
2021-10-15,42,Friday,October,2021,False,42,86674
2021-10-16,1,Saturday,October,2021,True,1,86675
2021-10-17,0,Sunday,October,2021,True,0,86675
2021-10-18,61,Monday,October,2021,False,61,86736
2021-10-19,147,Tuesday,October,2021,False,147,86883
2021-10-20,137,Wednesday,October,2021,False,137,87020
2021-10-21,50,Thursday,October,2021,False,50,87070
2021-10-22,74,Friday,October,2021,False,74,87144
2021-10-23,0,Saturday,October,2021,True,0,87144
2021-10-24,0,Sunday,October,2021,True,0,87144
2021-10-25,61,Monday,October,2021,False,61,87205
2021-10-26,189,Tuesday,October,2021,False,189,87394
2021-10-27,135,Wednesday,October,2021,False,135,87529
2021-10-28,44,Thursday,October,2021,False,44,87573
2021-10-29,63,Friday,October,2021,False,63,87636
2021-10-30,0,Saturday,October,2021,True,0,87636
2021-10-31,,Sunday,October,2021,True,0,87636
2021-11-01,57,Monday,November,2021,False,57,87693
2021-11-02,125,Tuesday,November,2021,False,125,87818
2021-11-03,133,Wednesday,November,2021,False,133,87951
2021-11-04,100,Thursday,November,2021,False,100,88051
2021-11-05,61,Friday,November,2021,False,61,88112
2021-11-06,1,Saturday,November,2021,True,1,88113
2021-11-07,0,Sunday,November,2021,True,0,88113
2021-11-08,85,Monday,November,2021,False,85,88198
2021-11-09,94,Tuesday,November,2021,False,94,88292
2021-11-10,61,Wednesday,November,2021,False,61,88353
2021-11-11,156,Thursday,November,2021,False,156,88509
2021-11-12,42,Friday,November,2021,False,42,88551
2021-11-13,6,Saturday,November,2021,True,6,88557
2021-11-14,1,Sunday,November,2021,True,1,88558
2021-11-15,65,Monday,November,2021,False,65,88623
2021-11-16,167,Tuesday,November,2021,False,167,88790
2021-11-17,101,Wednesday,November,2021,False,101,88891
2021-11-18,99,Thursday,November,2021,False,99,88990
2021-11-19,59,Friday,November,2021,False,59,89049
2021-11-20,0,Saturday,November,2021,True,0,89049
2021-11-21,0,Sunday,November,2021,True,0,89049
2021-11-22,67,Monday,November,2021,False,67,89116
2021-11-23,161,Tuesday,November,2021,False,161,89277
2021-11-24,93,Wednesday,November,2021,False,93,89370
2021-11-25,135,Thursday,November,2021,False,135,89505
2021-11-26,26,Friday,November,2021,False,26,89531
2021-11-27,0,Saturday,November,2021,True,0,89531
2021-11-28,0,Sunday,November,2021,True,0,89531
2021-11-29,64,Monday,November,2021,False,64,89595
2021-11-30,54,Tuesday,November,2021,False,54,89649
2021-12-01,90,Wednesday,December,2021,False,90,89739
2021-12-02,96,Thursday,December,2021,False,96,89835
2021-12-03,27,Friday,December,2021,False,27,89862
2021-12-04,0,Saturday,December,2021,True,0,89862
2021-12-05,0,Sunday,December,2021,True,0,89862
2021-12-06,84,Monday,December,2021,False,84,89946
2021-12-07,162,Tuesday,December,2021,False,162,90108
2021-12-08,74,Wednesday,December,2021,False,74,90182
2021-12-09,105,Thursday,December,2021,False,105,90287
2021-12-10,44,Friday,December,2021,False,44,90331
2021-12-11,1,Saturday,December,2021,True,1,90332
2021-12-12,0,Sunday,December,2021,True,0,90332
2021-12-13,71,Monday,December,2021,False,71,90403
2021-12-14,152,Tuesday,December,2021,False,152,90555
2021-12-15,141,Wednesday,December,2021,False,141,90696
2021-12-16,79,Thursday,December,2021,False,79,90775
2021-12-17,50,Friday,December,2021,False,50,90825
2021-12-18,15,Saturday,December,2021,True,15,90840
2021-12-19,0,Sunday,December,2021,True,0,90840
2021-12-20,107,Monday,December,2021,False,107,90947
2021-12-21,125,Tuesday,December,2021,False,125,91072
2021-12-22,119,Wednesday,December,2021,False,119,91191
2021-12-23,40,Thursday,December,2021,False,40,91231
2021-12-24,35,Friday,December,2021,False,35,91266
2021-12-25,0,Saturday,December,2021,True,0,91266
2021-12-26,0,Sunday,December,2021,True,0,91266
2021-12-27,75,Monday,December,2021,False,75,91341
2021-12-28,88,Tuesday,December,2021,False,88,91429
2021-12-29,63,Wednesday,December,2021,False,63,91492
2021-12-30,92,Thursday,December,2021,False,92,91584
2021-12-31,41,Friday,December,2021,False,41,91625
2022-01-01,4,Saturday,January,2022,True,4,91629
2022-01-02,0,Sunday,January,2022,True,0,91629
2022-01-03,36,Monday,January,2022,False,36,91665
2022-01-04,125,Tuesday,January,2022,False,125,91790
2022-01-05,134,Wednesday,January,2022,False,134,91924
2022-01-06,74,Thursday,January,2022,False,74,91998
2022-01-07,38,Friday,January,2022,False,38,92036
2022-01-08,0,Saturday,January,2022,True,0,92036
2022-01-09,0,Sunday,January,2022,True,0,92036
2022-01-10,31,Monday,January,2022,False,31,92067
2022-01-11,137,Tuesday,January,2022,False,137,92204
2022-01-12,163,Wednesday,January,2022,False,163,92367
2022-01-13,79,Thursday,January,2022,False,79,92446
2022-01-14,47,Friday,January,2022,False,47,92493
2022-01-15,0,Saturday,January,2022,True,0,92493
2022-01-16,1,Sunday,January,2022,True,1,92494
2022-01-17,43,Monday,January,2022,False,43,92537
2022-01-18,88,Tuesday,January,2022,False,88,92625
2022-01-19,89,Wednesday,January,2022,False,89,92714
2022-01-20,89,Thursday,January,2022,False,89,92803
2022-01-21,112,Friday,January,2022,False,112,92915
2022-01-22,5,Saturday,January,2022,True,5,92920
2022-01-23,,Sunday,January,2022,True,0,92920
2022-01-24,71,Monday,January,2022,False,71,92991
2022-01-25,163,Tuesday,January,2022,False,163,93154
2022-01-26,114,Wednesday,January,2022,False,114,93268
2022-01-27,91,Thursday,January,2022,False,91,93359
2022-01-28,57,Friday,January,2022,False,57,93416
2022-01-29,,Saturday,January,2022,True,0,93416
2022-01-30,,Sunday,January,2022,True,0,93416
2022-01-31,11,Monday,January,2022,False,11,93427
2022-02-01,123,Tuesday,February,2022,False,123,93550
2022-02-02,178,Wednesday,February,2022,False,178,93728
2022-02-03,90,Thursday,February,2022,False,90,93818
2022-02-04,56,Friday,February,2022,False,56,93874
2022-02-05,4,Saturday,February,2022,True,4,93878
2022-02-06,,Sunday,February,2022,True,0,93878
2022-02-07,45,Monday,February,2022,False,45,93923
2022-02-08,142,Tuesday,February,2022,False,142,94065
2022-02-09,105,Wednesday,February,2022,False,105,94170
2022-02-10,88,Thursday,February,2022,False,88,94258
2022-02-11,28,Friday,February,2022,False,28,94286
2022-02-12,10,Saturday,February,2022,True,10,94296
2022-02-13,,Sunday,February,2022,True,0,94296
2022-02-14,18,Monday,February,2022,False,18,94314
2022-02-15,132,Tuesday,February,2022,False,132,94446
2022-02-16,75,Wednesday,February,2022,False,75,94521
2022-02-17,110,Thursday,February,2022,False,110,94631
2022-02-18,62,Friday,February,2022,False,62,94693
2022-02-19,3,Saturday,February,2022,True,3,94696
2022-02-20,,Sunday,February,2022,True,0,94696
2022-02-21,18,Monday,February,2022,False,18,94714
2022-02-22,126,Tuesday,February,2022,False,126,94840
2022-02-23,68,Wednesday,February,2022,False,68,94908
2022-02-24,82,Thursday,February,2022,False,82,94990
2022-02-25,43,Friday,February,2022,False,43,95033
2022-02-26,,Saturday,February,2022,True,0,95033
2022-02-27,,Sunday,February,2022,True,0,95033
2022-02-28,23,Monday,February,2022,False,23,95056
2022-03-01,117,Tuesday,March,2022,False,117,95173
2022-03-02,106,Wednesday,March,2022,False,106,95279
2022-03-03,61,Thursday,March,2022,False,61,95340
2022-03-04,26,Friday,March,2022,False,26,95366
2022-03-05,,Saturday,March,2022,True,0,95366
2022-03-06,,Sunday,March,2022,True,0,95366
2022-03-07,30,Monday,March,2022,False,30,95396
2022-03-08,121,Tuesday,March,2022,False,121,95517
2022-03-09,108,Wednesday,March,2022,False,108,95625
2022-03-10,68,Thursday,March,2022,False,68,95693
2022-03-11,14,Friday,March,2022,False,14,95707
2022-03-12,,Saturday,March,2022,True,0,95707
2022-03-13,2,Sunday,March,2022,True,2,95709
2022-03-14,24,Monday,March,2022,False,24,95733
2022-03-15,116,Tuesday,March,2022,False,116,95849
2022-03-16,106,Wednesday,March,2022,False,106,95955
2022-03-17,79,Thursday,March,2022,False,79,96034
2022-03-18,29,Friday,March,2022,False,29,96063
2022-03-19,3,Saturday,March,2022,True,3,96066
2022-03-20,2,Sunday,March,2022,True,2,96068
2022-03-21,38,Monday,March,2022,False,38,96106
2022-03-22,111,Tuesday,March,2022,False,111,96217
2022-03-23,97,Wednesday,March,2022,False,97,96314
2022-03-24,88,Thursday,March,2022,False,88,96402
2022-03-25,22,Friday,March,2022,False,22,96424
2022-03-26,,Saturday,March,2022,True,0,96424
2022-03-27,4,Sunday,March,2022,True,4,96428
2022-03-28,38,Monday,March,2022,False,38,96466
2022-03-29,144,Tuesday,March,2022,False,144,96610
2022-03-30,80,Wednesday,March,2022,False,80,96690
2022-03-31,59,Thursday,March,2022,False,59,96749
2022-04-01,14,Friday,April,2022,False,14,96763
2022-04-02,5,Saturday,April,2022,True,5,96768
2022-04-03,,Sunday,April,2022,True,0,96768
2022-04-04,40,Monday,April,2022,False,40,96808
2022-04-05,100,Tuesday,April,2022,False,100,96908
2022-04-06,78,Wednesday,April,2022,False,78,96986
2022-04-07,62,Thursday,April,2022,False,62,97048
2022-04-08,19,Friday,April,2022,False,19,97067
2022-04-09,1,Saturday,April,2022,True,1,97068
2022-04-10,,Sunday,April,2022,True,0,97068
2022-04-11,42,Monday,April,2022,False,42,97110
2022-04-12,104,Tuesday,April,2022,False,104,97214
2022-04-13,89,Wednesday,April,2022,False,89,97303
2022-04-14,44,Thursday,April,2022,False,44,97347
2022-04-15,14,Friday,April,2022,False,14,97361
2022-04-16,,Saturday,April,2022,True,0,97361
2022-04-17,,Sunday,April,2022,True,0,97361
2022-04-18,16,Monday,April,2022,False,16,97377
2022-04-19,93,Tuesday,April,2022,False,93,97470
2022-04-20,115,Wednesday,April,2022,False,115,97585
2022-04-21,28,Thursday,April,2022,False,28,97613
2022-04-22,29,Friday,April,2022,False,29,97642
2022-04-23,,Saturday,April,2022,True,0,97642
2022-04-24,,Sunday,April,2022,True,0,97642
2022-04-25,27,Monday,April,2022,False,27,97669
2022-04-26,72,Tuesday,April,2022,False,72,97741
2022-04-27,94,Wednesday,April,2022,False,94,97835
2022-04-28,44,Thursday,April,2022,False,44,97879
2022-04-29,17,Friday,April,2022,False,17,97896
2022-04-30,,Saturday,April,2022,True,0,97896
2022-05-01,2,Sunday,May,2022,True,2,97898
2022-05-02,27,Monday,May,2022,False,27,97925
2022-05-03,59,Tuesday,May,2022,False,59,97984
2022-05-04,91,Wednesday,May,2022,False,91,98075
2022-05-05,48,Thursday,May,2022,False,48,98123
2022-05-06,31,Friday,May,2022,False,31,98154
2022-05-07,,Saturday,May,2022,True,0,98154
2022-05-08,,Sunday,May,2022,True,0,98154
2022-05-09,17,Monday,May,2022,False,17,98171
2022-05-10,80,Tuesday,May,2022,False,80,98251
2022-05-11,89,Wednesday,May,2022,False,89,98340
2022-05-12,45,Thursday,May,2022,False,45,98385
2022-05-13,21,Friday,May,2022,False,21,98406
2022-05-14,,Saturday,May,2022,True,0,98406
2022-05-15,,Sunday,May,2022,True,0,98406
2022-05-16,14,Monday,May,2022,False,14,98420
2022-05-17,13,Tuesday,May,2022,False,13,98433
2022-05-18,17,Wednesday,May,2022,False,17,98450
2022-05-19,63,Thursday,May,2022,False,63,98513
2022-05-20,48,Friday,May,2022,False,48,98561
2022-05-21,,Saturday,May,2022,True,0,98561
2022-05-22,2,Sunday,May,2022,True,2,98563
2022-05-23,15,Monday,May,2022,False,15,98578
2022-05-24,63,Tuesday,May,2022,False,63,98641
2022-05-25,60,Wednesday,May,2022,False,60,98701
2022-05-26,14,Thursday,May,2022,False,14,98715
2022-05-27,22,Friday,May,2022,False,22,98737
2022-05-28,,Saturday,May,2022,True,0,98737
2022-05-29,,Sunday,May,2022,True,0,98737
2022-05-30,13,Monday,May,2022,False,13,98750
2022-05-31,24,Tuesday,May,2022,False,24,98774
2022-06-01,75,Wednesday,June,2022,False,75,98849
2022-06-02,53,Thursday,June,2022,False,53,98902
2022-06-03,16,Friday,June,2022,False,16,98918
2022-06-04,,Saturday,June,2022,True,0,98918
2022-06-05,,Sunday,June,2022,True,0,98918
2022-06-06,16,Monday,June,2022,False,16,98934
2022-06-07,60,Tuesday,June,2022,False,60,98994
2022-06-08,58,Wednesday,June,2022,False,58,99052
2022-06-09,26,Thursday,June,2022,False,26,99078
2022-06-10,37,Friday,June,2022,False,37,99115
2022-06-11,1,Saturday,June,2022,True,1,99116
2022-06-12,,Sunday,June,2022,True,0,99116
2022-06-13,14,Monday,June,2022,False,14,99130
2022-06-14,62,Tuesday,June,2022,False,62,99192
2022-06-15,48,Wednesday,June,2022,False,48,99240
2022-06-16,29,Thursday,June,2022,False,29,99269
2022-06-17,17,Friday,June,2022,False,17,99286
2022-06-18,1,Saturday,June,2022,True,1,99287
2022-06-19,1,Sunday,June,2022,True,1,99288
2022-06-20,11,Monday,June,2022,False,11,99299
2022-06-21,52,Tuesday,June,2022,False,52,99351
2022-06-22,71,Wednesday,June,2022,False,71,99422
2022-06-23,42,Thursday,June,2022,False,42,99464
2022-06-24,24,Friday,June,2022,False,24,99488
2022-06-25,,Saturday,June,2022,True,0,99488
2022-06-26,,Sunday,June,2022,True,0,99488
2022-06-27,19,Monday,June,2022,False,19,99507
2022-06-28,35,Tuesday,June,2022,False,35,99542
2022-06-29,74,Wednesday,June,2022,False,74,99616
2022-06-30,34,Thursday,June,2022,False,34,99650
2022-07-01,21,Friday,July,2022,False,21,99671
2022-07-02,,Saturday,July,2022,True,0,99671
2022-07-03,,Sunday,July,2022,True,0,99671
2022-07-04,15,Monday,July,2022,False,15,99686
2022-07-05,46,Tuesday,July,2022,False,46,99732
2022-07-06,50,Wednesday,July,2022,False,50,99782
2022-07-07,44,Thursday,July,2022,False,44,99826
2022-07-08,36,Friday,July,2022,False,36,99862
2022-07-09,,Saturday,July,2022,True,0,99862
2022-07-10,,Sunday,July,2022,True,0,99862
2022-07-11,11,Monday,July,2022,False,11,99873
2022-07-12,29,Tuesday,July,2022,False,29,99902
2022-07-13,40,Wednesday,July,2022,False,40,99942
2022-07-14,43,Thursday,July,2022,False,43,99985
2022-07-15,20,Friday,July,2022,False,20,100005
2022-07-16,,Saturday,July,2022,True,0,100005
2022-07-17,,Sunday,July,2022,True,0,100005
2022-07-18,9,Monday,July,2022,False,9,100014
2022-07-19,39,Tuesday,July,2022,False,39,100053
2022-07-20,45,Wednesday,July,2022,False,45,100098
2022-07-21,40,Thursday,July,2022,False,40,100138
2022-07-22,15,Friday,July,2022,False,15,100153
2022-07-23,,Saturday,July,2022,True,0,100153
2022-07-24,,Sunday,July,2022,True,0,100153
2022-07-25,11,Monday,July,2022,False,11,100164
2022-07-26,26,Tuesday,July,2022,False,26,100190
2022-07-27,24,Wednesday,July,2022,False,24,100214
2022-07-28,21,Thursday,July,2022,False,21,100235
2022-07-29,30,Friday,July,2022,False,30,100265
2022-07-30,1,Saturday,July,2022,True,1,100266
2022-07-31,,Sunday,July,2022,True,0,100266
2022-08-01,6,Monday,August,2022,False,6,100272
2022-08-02,34,Tuesday,August,2022,False,34,100306
2022-08-03,27,Wednesday,August,2022,False,27,100333
2022-08-04,22,Thursday,August,2022,False,22,100355
2022-08-05,16,Friday,August,2022,False,16,100371
2022-08-06,,Saturday,August,2022,True,0,100371
2022-08-07,,Sunday,August,2022,True,0,100371
2022-08-08,16,Monday,August,2022,False,16,100387
2022-08-09,35,Tuesday,August,2022,False,35,100422
2022-08-10,29,Wednesday,August,2022,False,29,100451
2022-08-11,28,Thursday,August,2022,False,28,100479
2022-08-12,21,Friday,August,2022,False,21,100500
2022-08-13,,Saturday,August,2022,True,0,100500
2022-08-14,,Sunday,August,2022,True,0,100500
2022-08-15,6,Monday,August,2022,False,6,100506
2022-08-16,38,Tuesday,August,2022,False,38,100544
2022-08-17,31,Wednesday,August,2022,False,31,100575
2022-08-18,20,Thursday,August,2022,False,20,100595
2022-08-19,25,Friday,August,2022,False,25,100620
2022-08-20,,Saturday,August,2022,True,0,100620
2022-08-21,,Sunday,August,2022,True,0,100620
2022-08-22,9,Monday,August,2022,False,9,100629
2022-08-23,31,Tuesday,August,2022,False,31,100660
2022-08-24,28,Wednesday,August,2022,False,28,100688
2022-08-25,21,Thursday,August,2022,False,21,100709
2022-08-26,14,Friday,August,2022,False,14,100723
2022-08-27,,Saturday,August,2022,True,0,100723
2022-08-28,,Sunday,August,2022,True,0,100723
2022-08-29,15,Monday,August,2022,False,15,100738
2022-08-30,43,Tuesday,August,2022,False,43,100781
2022-08-31,17,Wednesday,August,2022,False,17,100798
2022-09-01,11,Thursday,September,2022,False,11,100809
2022-09-02,26,Friday,September,2022,False,26,100835
2022-09-03,,Saturday,September,2022,True,0,100835
2022-09-04,0,Sunday,September,2022,True,0,100835
2022-09-05,10,Monday,September,2022,False,10,100845
2022-09-06,32,Tuesday,September,2022,False,32,100877
2022-09-07,22,Wednesday,September,2022,False,22,100899
2022-09-08,27,Thursday,September,2022,False,27,100926
2022-09-09,35,Friday,September,2022,False,35,100961
2022-09-10,,Saturday,September,2022,True,0,100961
2022-09-11,,Sunday,September,2022,True,0,100961
2022-09-12,9,Monday,September,2022,False,9,100970
2022-09-13,20,Tuesday,September,2022,False,20,100990
2022-09-14,34,Wednesday,September,2022,False,34,101024
2022-09-15,21,Thursday,September,2022,False,21,101045
2022-09-16,11,Friday,September,2022,False,11,101056
2022-09-17,,Saturday,September,2022,True,0,101056
2022-09-18,,Sunday,September,2022,True,0,101056
2022-09-19,10,Monday,September,2022,False,10,101066
2022-09-20,24,Tuesday,September,2022,False,24,101090
2022-09-21,28,Wednesday,September,2022,False,28,101118
2022-09-22,22,Thursday,September,2022,False,22,101140
2022-09-23,17,Friday,September,2022,False,17,101157
2022-09-24,1,Saturday,September,2022,True,1,101158
2022-09-25,,Sunday,September,2022,True,0,101158
2022-09-26,10,Monday,September,2022,False,10,101168
2022-09-27,19,Tuesday,September,2022,False,19,101187
2022-09-28,10,Wednesday,September,2022,False,10,101197
2022-09-29,11,Thursday,September,2022,False,11,101208
2022-09-30,7,Friday,September,2022,False,7,101215
2022-10-01,,Saturday,October,2022,True,0,101215
2022-10-02,,Sunday,October,2022,True,0,101215
2022-10-03,6,Monday,October,2022,False,6,101221
2022-10-04,11,Tuesday,October,2022,False,11,101232
2022-10-05,19,Wednesday,October,2022,False,19,101251
2022-10-06,15,Thursday,October,2022,False,15,101266
2022-10-07,16,Friday,October,2022,False,16,101282
2022-10-08,,Saturday,October,2022,True,0,101282
2022-10-09,,Sunday,October,2022,True,0,101282
2022-10-10,14,Monday,October,2022,False,14,101296
2022-10-11,21,Tuesday,October,2022,False,21,101317
2022-10-12,19,Wednesday,October,2022,False,19,101336
2022-10-13,20,Thursday,October,2022,False,20,101356
2022-10-14,17,Friday,October,2022,False,17,101373
2022-10-15,,Saturday,October,2022,True,0,101373
2022-10-16,,Sunday,October,2022,True,0,101373
2022-10-17,15,Monday,October,2022,False,15,101388
2022-10-18,41,Tuesday,October,2022,False,41,101429
2022-10-19,19,Wednesday,October,2022,False,19,101448
2022-10-20,13,Thursday,October,2022,False,13,101461
2022-10-21,19,Friday,October,2022,False,19,101480
2022-10-22,,Saturday,October,2022,True,0,101480
2022-10-23,1,Sunday,October,2022,True,1,101481
2022-10-24,11,Monday,October,2022,False,11,101492
2022-10-25,30,Tuesday,October,2022,False,30,101522
2022-10-26,25,Wednesday,October,2022,False,25,101547
2022-10-27,18,Thursday,October,2022,False,18,101565
2022-10-28,14,Friday,October,2022,False,14,101579
2022-10-29,,Saturday,October,2022,True,0,101579
2022-10-30,,Sunday,October,2022,True,0,101579
2022-10-31,5,Monday,October,2022,False,5,101584
2022-11-01,21,Tuesday,November,2022,False,21,101605
2022-11-02,25,Wednesday,November,2022,False,25,101630
2022-11-03,16,Thursday,November,2022,False,16,101646
2022-11-04,12,Friday,November,2022,False,12,101658
2022-11-05,,Saturday,November,2022,True,0,101658
2022-11-06,1,Sunday,November,2022,True,1,101659
2022-11-07,10,Monday,November,2022,False,10,101669
2022-11-08,28,Tuesday,November,2022,False,28,101697
2022-11-09,14,Wednesday,November,2022,False,14,101711
2022-11-10,15,Thursday,November,2022,False,15,101726
2022-11-11,20,Friday,November,2022,False,20,101746
2022-11-12,,Saturday,November,2022,True,0,101746
2022-11-13,,Sunday,November,2022,True,0,101746
2022-11-14,14,Monday,November,2022,False,14,101760
2022-11-15,30,Tuesday,November,2022,False,30,101790
2022-11-16,21,Wednesday,November,2022,False,21,101811
2022-11-17,14,Thursday,November,2022,False,14,101825
2022-11-18,14,Friday,November,2022,False,14,101839
2022-11-19,3,Saturday,November,2022,True,3,101842
2022-11-20,,Sunday,November,2022,True,0,101842
2022-11-21,7,Monday,November,2022,False,7,101849
2022-11-22,12,Tuesday,November,2022,False,12,101861
2022-11-23,9,Wednesday,November,2022,False,9,101870
2022-11-24,10,Thursday,November,2022,False,10,101880
2022-11-25,11,Friday,November,2022,False,11,101891
2022-11-26,,Saturday,November,2022,True,0,101891
2022-11-27,,Sunday,November,2022,True,0,101891
2022-11-28,,Monday,November,2022,False,0,101891
2022-11-29,13,Tuesday,November,2022,False,13,101904
2022-11-30,18,Wednesday,November,2022,False,18,101922
2022-12-01,19,Thursday,December,2022,False,19,101941
2022-12-02,13,Friday,December,2022,False,13,101954
2022-12-03,,Saturday,December,2022,True,0,101954
2022-12-04,,Sunday,December,2022,True,0,101954
2022-12-05,13,Monday,December,2022,False,13,101967
2022-12-06,38,Tuesday,December,2022,False,38,102005
2022-12-07,13,Wednesday,December,2022,False,13,102018
2022-12-08,20,Thursday,December,2022,False,20,102038
2022-12-09,5,Friday,December,2022,False,5,102043
2022-12-10,,Saturday,December,2022,True,0,102043
2022-12-11,,Sunday,December,2022,True,0,102043
2022-12-12,10,Monday,December,2022,False,10,102053
2022-12-13,15,Tuesday,December,2022,False,15,102068
2022-12-14,6,Wednesday,December,2022,False,6,102074
2022-12-15,12,Thursday,December,2022,False,12,102086
2022-12-16,4,Friday,December,2022,False,4,102090
2022-12-17,1,Saturday,December,2022,True,1,102091
2022-12-18,,Sunday,December,2022,True,0,102091
2022-12-19,4,Monday,December,2022,False,4,102095
2022-12-20,14,Tuesday,December,2022,False,14,102109
2022-12-21,11,Wednesday,December,2022,False,11,102120
2022-12-22,9,Thursday,December,2022,False,9,102129
2022-12-23,4,Friday,December,2022,False,4,102133
2022-12-24,,Saturday,December,2022,True,0,102133
2022-12-25,,Sunday,December,2022,True,0,102133
2022-12-26,,Monday,December,2022,False,0,102133
2022-12-27,5,Tuesday,December,2022,False,5,102138
2022-12-28,8,Wednesday,December,2022,False,8,102146
2022-12-29,4,Thursday,December,2022,False,4,102150
2022-12-30,2,Friday,December,2022,False,2,102152
2022-12-31,,Saturday,December,2022,True,0,102152
2023-01-01,,Sunday,January,2023,True,0,102152
2023-01-02,8,Monday,January,2023,False,8,102160
2023-01-03,9,Tuesday,January,2023,False,9,102169
2023-01-04,7,Wednesday,January,2023,False,7,102176
2023-01-05,14,Thursday,January,2023,False,14,102190
2023-01-06,7,Friday,January,2023,False,7,102197
2023-01-07,4,Saturday,January,2023,True,4,102201
2023-01-08,,Sunday,January,2023,True,0,102201
2023-01-09,6,Monday,January,2023,False,6,102207
2023-01-10,31,Tuesday,January,2023,False,31,102238
2023-01-11,26,Wednesday,January,2023,False,26,102264
2023-01-12,11,Thursday,January,2023,False,11,102275
2023-01-13,14,Friday,January,2023,False,14,102289
2023-01-14,,Saturday,January,2023,True,0,102289
2023-01-15,,Sunday,January,2023,True,0,102289
2023-01-16,8,Monday,January,2023,False,8,102297
2023-01-17,25,Tuesday,January,2023,False,25,102322
2023-01-18,16,Wednesday,January,2023,False,16,102338
2023-01-19,26,Thursday,January,2023,False,26,102364
2023-01-20,11,Friday,January,2023,False,11,102375
2023-01-21,,Saturday,January,2023,True,0,102375
2023-01-22,,Sunday,January,2023,True,0,102375
2023-01-23,5,Monday,January,2023,False,5,102380
2023-01-24,8,Tuesday,January,2023,False,8,102388
2023-01-25,25,Wednesday,January,2023,False,25,102413
2023-01-26,16,Thursday,January,2023,False,16,102429
2023-01-27,14,Friday,January,2023,False,14,102443
2023-01-28,,Saturday,January,2023,True,0,102443
2023-01-29,,Sunday,January,2023,True,0,102443
2023-01-30,6,Monday,January,2023,False,6,102449
2023-01-31,15,Tuesday,January,2023,False,15,102464
2023-02-01,20,Wednesday,February,2023,False,20,102484
2023-02-02,11,Thursday,February,2023,False,11,102495
2023-02-03,8,Friday,February,2023,False,8,102503
2023-02-04,,Saturday,February,2023,True,0,102503
2023-02-05,,Sunday,February,2023,True,0,102503
2023-02-06,11,Monday,February,2023,False,11,102514
2023-02-07,22,Tuesday,February,2023,False,22,102536
2023-02-08,12,Wednesday,February,2023,False,12,102548
2023-02-09,9,Thursday,February,2023,False,9,102557
2023-02-10,12,Friday,February,2023,False,12,102569
2023-02-11,,Saturday,February,2023,True,0,102569
2023-02-12,,Sunday,February,2023,True,0,102569
2023-02-13,,Monday,February,2023,False,0,102569
2023-02-14,18,Tuesday,February,2023,False,18,102587
2023-02-15,25,Wednesday,February,2023,False,25,102612
2023-02-16,12,Thursday,February,2023,False,12,102624
2023-02-17,11,Friday,February,2023,False,11,102635
2023-02-18,,Saturday,February,2023,True,0,102635
2023-02-19,,Sunday,February,2023,True,0,102635
2023-02-20,12,Monday,February,2023,False,12,102647
2023-02-21,14,Tuesday,February,2023,False,14,102661
2023-02-22,15,Wednesday,February,2023,False,15,102676
2023-02-23,14,Thursday,February,2023,False,14,102690
2023-02-24,5,Friday,February,2023,False,5,102695
2023-02-25,,Saturday,February,2023,True,0,102695
2023-02-26,,Sunday,February,2023,True,0,102695
2023-02-27,1,Monday,February,2023,False,1,102696
2023-02-28,17,Tuesday,February,2023,False,17,102713
2023-03-01,17,Wednesday,March,2023,False,17,102730
2023-03-02,19,Thursday,March,2023,False,19,102749
2023-03-03,12,Friday,March,2023,False,12,102761
2023-03-04,,Saturday,March,2023,True,0,102761
2023-03-05,,Sunday,March,2023,True,0,102761
2023-03-06,9,Monday,March,2023,False,9,102770
2023-03-07,31,Tuesday,March,2023,False,31,102801
2023-03-08,34,Wednesday,March,2023,False,34,102835
2023-03-09,11,Thursday,March,2023,False,11,102846
2023-03-10,20,Friday,March,2023,False,20,102866
2023-03-11,,Saturday,March,2023,True,0,102866
2023-03-12,,Sunday,March,2023,True,0,102866
2023-03-13,,Monday,March,2023,False,0,102866
2023-03-14,29,Tuesday,March,2023,False,29,102895
2023-03-15,24,Wednesday,March,2023,False,24,102919
2023-03-16,29,Thursday,March,2023,False,29,102948
2023-03-17,10,Friday,March,2023,False,10,102958
2023-03-18,,Saturday,March,2023,True,0,102958
2023-03-19,,Sunday,March,2023,True,0,102958
2023-03-20,,Monday,March,2023,False,0,102958
2023-03-21,26,Tuesday,March,2023,False,26,102984
2023-03-22,24,Wednesday,March,2023,False,24,103008
2023-03-23,14,Thursday,March,2023,False,14,103022
2023-03-24,6,Friday,March,2023,False,6,103028
2023-03-25,,Saturday,March,2023,True,0,103028
2023-03-26,,Sunday,March,2023,True,0,103028
2023-03-27,5,Monday,March,2023,False,5,103033
2023-03-28,16,Tuesday,March,2023,False,16,103049
2023-03-29,17,Wednesday,March,2023,False,17,103066
2023-03-30,12,Thursday,March,2023,False,12,103078
2023-03-31,5,Friday,March,2023,False,5,103083
2023-04-01,2,Saturday,April,2023,True,2,103085
2023-04-02,,Sunday,April,2023,True,0,103085
2023-04-03,7,Monday,April,2023,False,7,103092
2023-04-04,27,Tuesday,April,2023,False,27,103119
2023-04-05,22,Wednesday,April,2023,False,22,103141
2023-04-06,19,Thursday,April,2023,False,19,103160
2023-04-07,6,Friday,April,2023,False,6,103166
2023-04-08,,Saturday,April,2023,True,0,103166
2023-04-09,,Sunday,April,2023,True,0,103166
2023-04-10,12,Monday,April,2023,False,12,103178
2023-04-11,26,Tuesday,April,2023,False,26,103204
2023-04-12,26,Wednesday,April,2023,False,26,103230
2023-04-13,21,Thursday,April,2023,False,21,103251
2023-04-14,10,Friday,April,2023,False,10,103261
2023-04-15,,Saturday,April,2023,True,0,103261
2023-04-16,,Sunday,April,2023,True,0,103261
2023-04-17,15,Monday,April,2023,False,15,103276
2023-04-18,21,Tuesday,April,2023,False,21,103297
2023-04-19,26,Wednesday,April,2023,False,26,103323
2023-04-20,23,Thursday,April,2023,False,23,103346
2023-04-21,9,Friday,April,2023,False,9,103355
2023-04-22,,Saturday,April,2023,True,0,103355
2023-04-23,,Sunday,April,2023,True,0,103355
2023-04-24,9,Monday,April,2023,False,9,103364
2023-04-25,38,Tuesday,April,2023,False,38,103402
2023-04-26,18,Wednesday,April,2023,False,18,103420
2023-04-27,9,Thursday,April,2023,False,9,103429
2023-04-28,7,Friday,April,2023,False,7,103436
2023-04-29,,Saturday,April,2023,True,0,103436
2023-04-30,,Sunday,April,2023,True,0,103436
2023-05-01,1,Monday,May,2023,False,1,103437
2023-05-02,21,Tuesday,May,2023,False,21,103458
2023-05-03,16,Wednesday,May,2023,False,16,103474
2023-05-04,21,Thursday,May,2023,False,21,103495
2023-05-05,15,Friday,May,2023,False,15,103510
2023-05-06,,Saturday,May,2023,True,0,103510
2023-05-07,,Sunday,May,2023,True,0,103510
2023-05-08,11,Monday,May,2023,False,11,103521
2023-05-09,39,Tuesday,May,2023,False,39,103560
2023-05-10,21,Wednesday,May,2023,False,21,103581
2023-05-11,21,Thursday,May,2023,False,21,103602
2023-05-12,9,Friday,May,2023,False,9,103611
2023-05-13,,Saturday,May,2023,True,0,103611
2023-05-14,,Sunday,May,2023,True,0,103611
2023-05-15,,Monday,May,2023,False,0,103611
2023-05-16,38,Tuesday,May,2023,False,38,103649
2023-05-17,20,Wednesday,May,2023,False,20,103669
2023-05-18,14,Thursday,May,2023,False,14,103683
2023-05-19,13,Friday,May,2023,False,13,103696
2023-05-20,,Saturday,May,2023,True,0,103696
2023-05-21,,Sunday,May,2023,True,0,103696
2023-05-22,10,Monday,May,2023,False,10,103706
2023-05-23,28,Tuesday,May,2023,False,28,103734
2023-05-24,19,Wednesday,May,2023,False,19,103753
2023-05-25,19,Thursday,May,2023,False,19,103772
2023-05-26,7,Friday,May,2023,False,7,103779
2023-05-27,1,Saturday,May,2023,True,1,103780
2023-05-28,,Sunday,May,2023,True,0,103780
2023-05-29,1,Monday,May,2023,False,1,103781
2023-05-30,4,Tuesday,May,2023,False,4,103785
2023-05-31,17,Wednesday,May,2023,False,17,103802
2023-06-01,17,Thursday,June,2023,False,17,103819
2023-06-02,6,Friday,June,2023,False,6,103825
2023-06-03,,Saturday,June,2023,True,0,103825
2023-06-04,,Sunday,June,2023,True,0,103825
2023-06-05,6,Monday,June,2023,False,6,103831
2023-06-06,24,Tuesday,June,2023,False,24,103855
2023-06-07,9,Wednesday,June,2023,False,9,103864
2023-06-08,18,Thursday,June,2023,False,18,103882
2023-06-09,14,Friday,June,2023,False,14,103896
2023-06-10,,Saturday,June,2023,True,0,103896
2023-06-11,,Sunday,June,2023,True,0,103896
2023-06-12,4,Monday,June,2023,False,4,103900
2023-06-13,35,Tuesday,June,2023,False,35,103935
2023-06-14,20,Wednesday,June,2023,False,20,103955
2023-06-15,19,Thursday,June,2023,False,19,103974
2023-06-16,12,Friday,June,2023,False,12,103986
2023-06-17,,Saturday,June,2023,True,0,103986
2023-06-18,,Sunday,June,2023,True,0,103986
2023-06-19,7,Monday,June,2023,False,7,103993
2023-06-20,24,Tuesday,June,2023,False,24,104017
2023-06-21,17,Wednesday,June,2023,False,17,104034
2023-06-22,15,Thursday,June,2023,False,15,104049
2023-06-23,8,Friday,June,2023,False,8,104057
2023-06-24,,Saturday,June,2023,True,0,104057
2023-06-25,,Sunday,June,2023,True,0,104057
2023-06-26,8,Monday,June,2023,False,8,104065
2023-06-27,26,Tuesday,June,2023,False,26,104091
2023-06-28,9,Wednesday,June,2023,False,9,104100
2023-06-29,5,Thursday,June,2023,False,5,104105
2023-06-30,9,Friday,June,2023,False,9,104114
2023-07-01,,Saturday,July,2023,True,0,104114
2023-07-02,,Sunday,July,2023,True,0,104114
2023-07-03,,Monday,July,2023,False,0,104114
2023-07-04,9,Tuesday,July,2023,False,9,104123
2023-07-05,14,Wednesday,July,2023,False,14,104137
2023-07-06,25,Thursday,July,2023,False,25,104162
2023-07-07,10,Friday,July,2023,False,10,104172
2023-07-08,,Saturday,July,2023,True,0,104172
2023-07-09,,Sunday,July,2023,True,0,104172
2023-07-10,11,Monday,July,2023,False,11,104183
2023-07-11,29,Tuesday,July,2023,False,29,104212
2023-07-12,23,Wednesday,July,2023,False,23,104235
2023-07-13,29,Thursday,July,2023,False,29,104264
2023-07-14,20,Friday,July,2023,False,20,104284
2023-07-15,,Saturday,July,2023,True,0,104284
2023-07-16,,Sunday,July,2023,True,0,104284
2023-07-17,13,Monday,July,2023,False,13,104297
2023-07-18,48,Tuesday,July,2023,False,48,104345
2023-07-19,20,Wednesday,July,2023,False,20,104365
2023-07-20,21,Thursday,July,2023,False,21,104386
2023-07-21,8,Friday,July,2023,False,8,104394
2023-07-22,,Saturday,July,2023,True,0,104394
2023-07-23,,Sunday,July,2023,True,0,104394
2023-07-24,5,Monday,July,2023,False,5,104399
2023-07-25,22,Tuesday,July,2023,False,22,104421
2023-07-26,9,Wednesday,July,2023,False,9,104430
2023-07-27,11,Thursday,July,2023,False,11,104441
2023-07-28,9,Friday,July,2023,False,9,104450
2023-07-29,,Saturday,July,2023,True,0,104450
2023-07-30,,Sunday,July,2023,True,0,104450
2023-07-31,,Monday,July,2023,False,0,104450
2023-08-01,17,Tuesday,August,2023,False,17,104467
2023-08-02,17,Wednesday,August,2023,False,17,104484
2023-08-03,16,Thursday,August,2023,False,16,104500
2023-08-04,18,Friday,August,2023,False,18,104518
2023-08-05,,Saturday,August,2023,True,0,104518
2023-08-06,,Sunday,August,2023,True,0,104518
2023-08-07,13,Monday,August,2023,False,13,104531
2023-08-08,41,Tuesday,August,2023,False,41,104572
2023-08-09,24,Wednesday,August,2023,False,24,104596
2023-08-10,18,Thursday,August,2023,False,18,104614
2023-08-11,13,Friday,August,2023,False,13,104627
2023-08-12,,Saturday,August,2023,True,0,104627
2023-08-13,,Sunday,August,2023,True,0,104627
2023-08-14,12,Monday,August,2023,False,12,104639
2023-08-15,35,Tuesday,August,2023,False,35,104674
2023-08-16,25,Wednesday,August,2023,False,25,104699
2023-08-17,12,Thursday,August,2023,False,12,104711
2023-08-18,16,Friday,August,2023,False,16,104727
2023-08-19,0,Saturday,August,2023,True,0,104727
2023-08-20,0,Sunday,August,2023,True,0,104727
2023-08-21,6,Monday,August,2023,False,6,104733
2023-08-22,23,Tuesday,August,2023,False,23,104756
2023-08-23,10,Wednesday,August,2023,False,10,104766
2023-08-24,14,Thursday,August,2023,False,14,104780
2023-08-25,2,Friday,August,2023,False,2,104782
2023-08-26,0,Saturday,August,2023,True,0,104782
2023-08-27,0,Sunday,August,2023,True,0,104782
2023-08-28,1,Monday,August,2023,False,1,104783
2023-08-29,23,Tuesday,August,2023,False,23,104806
2023-08-30,8,Wednesday,August,2023,False,8,104814
2023-08-31,18,Thursday,August,2023,False,18,104832
2023-09-01,21,Friday,September,2023,False,21,104853
2023-09-02,2,Saturday,September,2023,True,2,104855
2023-09-03,0,Sunday,September,2023,True,0,104855
2023-09-04,10,Monday,September,2023,False,10,104865
2023-09-05,26,Tuesday,September,2023,False,26,104891
2023-09-06,14,Wednesday,September,2023,False,14,104905
2023-09-07,21,Thursday,September,2023,False,21,104926
2023-09-08,12,Friday,September,2023,False,12,104938
2023-09-09,3,Saturday,September,2023,True,3,104941
2023-09-10,1,Sunday,September,2023,True,1,104942
2023-09-11,8,Monday,September,2023,False,8,104950
2023-09-12,35,Tuesday,September,2023,False,35,104985
2023-09-13,21,Wednesday,September,2023,False,21,105006
2023-09-14,12,Thursday,September,2023,False,12,105018
2023-09-15,15,Friday,September,2023,False,15,105033
2023-09-16,0,Saturday,September,2023,True,0,105033
2023-09-17,0,Sunday,September,2023,True,0,105033
2023-09-18,8,Monday,September,2023,False,8,105041
2023-09-19,30,Tuesday,September,2023,False,30,105071
2023-09-20,28,Wednesday,September,2023,False,28,105099
2023-09-21,34,Thursday,September,2023,False,34,105133
2023-09-22,18,Friday,September,2023,False,18,105151
2023-09-23,0,Saturday,September,2023,True,0,105151
2023-09-24,0,Sunday,September,2023,True,0,105151
2023-09-25,10,Monday,September,2023,False,10,105161
2023-09-26,22,Tuesday,September,2023,False,22,105183
2023-09-27,6,Wednesday,September,2023,False,6,105189
2023-09-28,17,Thursday,September,2023,False,17,105206
2023-09-29,7,Friday,September,2023,False,7,105213
2023-09-30,0,Saturday,September,2023,True,0,105213
2023-10-01,0,Sunday,October,2023,True,0,105213
2023-10-02,2,Monday,October,2023,False,2,105215
2023-10-03,10,Tuesday,October,2023,False,10,105225
2023-10-04,13,Wednesday,October,2023,False,13,105238
2023-10-05,12,Thursday,October,2023,False,12,105250
2023-10-06,3,Friday,October,2023,False,3,105253
2023-10-07,0,Saturday,October,2023,True,0,105253
2023-10-08,2,Sunday,October,2023,True,2,105255
2023-10-09,5,Monday,October,2023,False,5,105260
2023-10-10,17,Tuesday,October,2023,False,17,105277
2023-10-11,8,Wednesday,October,2023,False,8,105285
2023-10-12,12,Thursday,October,2023,False,12,105297
2023-10-13,9,Friday,October,2023,False,9,105306
2023-10-14,0,Saturday,October,2023,True,0,105306
2023-10-15,0,Sunday,October,2023,True,0,105306
2023-10-16,2,Monday,October,2023,False,2,105308
2023-10-17,18,Tuesday,October,2023,False,18,105326
2023-10-18,14,Wednesday,October,2023,False,14,105340
2023-10-19,15,Thursday,October,2023,False,15,105355
2023-10-20,7,Friday,October,2023,False,7,105362
2023-10-21,0,Saturday,October,2023,True,0,105362
2023-10-22,0,Sunday,October,2023,True,0,105362
2023-10-23,4,Monday,October,2023,False,4,105366
2023-10-24,23,Tuesday,October,2023,False,23,105389
2023-10-25,8,Wednesday,October,2023,False,8,105397
2023-10-26,11,Thursday,October,2023,False,11,105408
2023-10-27,8,Friday,October,2023,False,8,105416
2023-10-28,2,Saturday,October,2023,True,2,105418
2023-10-29,0,Sunday,October,2023,True,0,105418
2023-10-30,0,Monday,October,2023,False,0,105418
2023-10-31,11,Tuesday,October,2023,False,11,105429
2023-11-01,8,Wednesday,November,2023,False,8,105437
2023-11-02,11,Thursday,November,2023,False,11,105448
2023-11-03,10,Friday,November,2023,False,10,105458
2023-11-04,1,Saturday,November,2023,True,1,105459
2023-11-05,0,Sunday,November,2023,True,0,105459
2023-11-06,1,Monday,November,2023,False,1,105460
2023-11-07,8,Tuesday,November,2023,False,8,105468
2023-11-08,16,Wednesday,November,2023,False,16,105484
2023-11-09,7,Thursday,November,2023,False,7,105491
2023-11-10,8,Friday,November,2023,False,8,105499
2023-11-11,0,Saturday,November,2023,True,0,105499
2023-11-12,0,Sunday,November,2023,True,0,105499
2023-11-13,3,Monday,November,2023,False,3,105502
2023-11-14,14,Tuesday,November,2023,False,14,105516
2023-11-15,10,Wednesday,November,2023,False,10,105526
2023-11-16,15,Thursday,November,2023,False,15,105541
2023-11-17,8,Friday,November,2023,False,8,105549
2023-11-18,1,Saturday,November,2023,True,1,105550
2023-11-19,0,Sunday,November,2023,True,0,105550
2023-11-20,8,Monday,November,2023,False,8,105558
2023-11-21,19,Tuesday,November,2023,False,19,105577
2023-11-22,13,Wednesday,November,2023,False,13,105590
2023-11-23,6,Thursday,November,2023,False,6,105596
2023-11-24,3,Friday,November,2023,False,3,105599
2023-11-25,1,Saturday,November,2023,True,1,105600
2023-11-26,0,Sunday,November,2023,True,0,105600
2023-11-27,0,Monday,November,2023,False,0,105600
2023-11-28,21,Tuesday,November,2023,False,21,105621
2023-11-29,5,Wednesday,November,2023,False,5,105626
2023-11-30,9,Thursday,November,2023,False,9,105635
2023-12-01,9,Friday,December,2023,False,9,105644
2023-12-02,1,Saturday,December,2023,True,1,105645
2023-12-03,0,Sunday,December,2023,True,0,105645
2023-12-04,3,Monday,December,2023,False,3,105648
2023-12-05,15,Tuesday,December,2023,False,15,105663
2023-12-06,18,Wednesday,December,2023,False,18,105681
2023-12-07,12,Thursday,December,2023,False,12,105693
2023-12-08,8,Friday,December,2023,False,8,105701
2023-12-09,0,Saturday,December,2023,True,0,105701
2023-12-10,1,Sunday,December,2023,True,1,105702
2023-12-11,2,Monday,December,2023,False,2,105704
2023-12-12,18,Tuesday,December,2023,False,18,105722
2023-12-13,2,Wednesday,December,2023,False,2,105724
2023-12-14,9,Thursday,December,2023,False,9,105733
2023-12-15,4,Friday,December,2023,False,4,105737
2023-12-16,0,Saturday,December,2023,True,0,105737
2023-12-17,1,Sunday,December,2023,True,1,105738
2023-12-18,1,Monday,December,2023,False,1,105739
2023-12-19,17,Tuesday,December,2023,False,17,105756
2023-12-20,5,Wednesday,December,2023,False,5,105761
2023-12-21,6,Thursday,December,2023,False,6,105767
2023-12-22,3,Friday,December,2023,False,3,105770
2023-12-23,0,Saturday,December,2023,True,0,105770
2023-12-24,0,Sunday,December,2023,True,0,105770
2023-12-25,0,Monday,December,2023,False,0,105770
2023-12-26,0,Tuesday,December,2023,False,0,105770
2023-12-27,2,Wednesday,December,2023,False,2,105772
2023-12-28,5,Thursday,December,2023,False,5,105777
2023-12-29,5,Friday,December,2023,False,5,105782
2023-12-30,0,Saturday,December,2023,True,0,105782
2023-12-31,0,Sunday,December,2023,True,0,105782
